倆	𠈓
儘	侭
儼	𠑊
剾	𠛅
勁	𠡍
卮	巵
啐	𠯥
啞	唖
嚙	噛
囋	𡂐
埣	𡉻
塿	𪣻
壗	𡋤
壠	𡏡
孻	𡥧
寠	𪧘
屛	屏
嶞	𡺆
幷	并
彎	弯
懣	𢡛
挳	𢫞
捽	𢪄
搔	掻
摑	掴
撈	𢭐
撥	𫝼
擣	𢭏
攏	𢲣
攪	撹
斂	㪘
斅	𢽾
晬	𣅢
枡	桝
櫷	𪳥
欓	𣗋
濾	沪
灙	𣺼
烴	𤇂
犢	㸿
瞞	𥈞
硜	𥑋
禱	祷
穎	頴
箋	䇳
篸	𥮾
簞	箪
粵	粤
縷	𫃵
繡	繍
繹	䋇
脛	𦙾
臍	𦜝
蔣	蒋
蕭	䔥
藪	薮
蘆	芦
蠅	蝿
蠟	蝋
謳	𧦅
讜	𧫆
貗	𫎌
踁	𨀃
躋	𨂋
轝	𨊮
遱	𫐷
鄰	隣
醬	醤
鋞	𫒔
鏒	𨨕
鏤	𨩐
陘	𫔽
隮	𫕅
隴	𨻫
髡	髠
鷗	鴎
鹼	鹸
麬	𤿲
麴	麹
鼬	𫠘
龝	穐
𩯁	𫙂
