上伏塔	上沃爾特
上哈爾茨	上哈茲
上哈茨	上哈茲
上奧地利邦	上奧地利州
上沃爾特	上伏塔
下奧地利邦	下奧地利州
下薩克森邦	下薩克森州
不來梅	不萊梅
不來梅哈芬	不萊梅港
不來梅州	不萊梅州
不倫瑞克	賓士域
不列顛哥倫比亞	卑詩
丹地	登地
丹帕沙	登巴薩
主權基地區	主權根據地區
乍得	查德
亞他加馬	阿他加馬
亞伯丁	鴨巴甸
亞克羅提利	德基利亞 阿克魯帝利
亞克羅提利和德凱利亞	阿克魯帝利及德基利亞
亞克羅提利與德凱利亞	阿克魯帝利及德基利亞
亞塞拜然	阿塞拜疆
亞拉倫拉	雅拉倫拉
亞拉岡	阿拉貢
亞本塞	阿彭策爾
亞森欣	阿森松
亞歷山卓	亞歷山大港
亞沃利夫	亞沃里夫
亞爾薩斯	阿爾薩斯
亞特蘭大	阿特蘭大
亞琛	阿亨
亞穆蘇克羅	雅穆索戈
亞細安	東盟
亞細安組織	東南亞國家聯盟
亞維農	阿維尼翁
亞辛	雅欣
亞速群島	亞速爾羣島
亞雅	葉海亞
亞馬孫	亞馬遜
京斯惇	京士頓
京斯頓	京士惇 京士頓
什切青	斯塞新
什列斯威	石勒蘇益格
什勒斯維希	石勒蘇益格
什未林	施威林
什羅普	史樂
什霍邦	石荷州
什魯斯伯里	梳士貝利
伊令	伊靈
伊凡諾	伊萬諾
伊利諾伊	伊利諾
伊卡盧伊特	伊魁特
伊布拉欣	易卜拉欣
伊斯坦布爾	伊斯坦堡
伊斯林頓	伊斯靈頓
伊斯梅爾	依斯邁
伊斯蘭瑪巴德	伊斯蘭堡
伊普斯威奇	葉士域治
伊普斯維奇	葉士域治
伊比利	伊比利亞
伊洛伊洛	依路
伊珀爾	伊伯
伊瓦諾	伊凡
伊納姆克洛	伊南克洛
伊莉莎白港	伊利沙伯港
伊萬諾	伊凡
伊麗莎白港	伊利沙伯港
伍利奇	胡列治
伍德蘭	森林地
伍斯特	窩士打
伍爾弗漢普頓	和夫咸頓
伍玆	活士
伍珀塔爾	烏帕塔爾
伍珀河	烏帕河
伏伊伏丁那	禾獲甸拿
伏林	沃倫
休倫	曉倫
休士頓	侯斯頓
休斯惇	侯斯頓
休斯頓	侯斯頓
伯克利	柏克萊
伯利玆	伯利茲
伯恩	伯爾尼
伯恩利	般尼
伯恩茅斯	般尼茅夫
伯恩賽德	濱世
伯斯	巴富 珀斯
伯明罕	伯明翰
伯班克	柏本克
伯立克	巴域
伯靈頓	布靈頓
佛伊弗迪納	禾獲甸拿
佛德州	沃州
佛拉蒙	弗拉芒
佛羅倫薩	佛羅倫斯
佛茨海姆	普福爾茨海姆
佛萊明	弗拉芒
佛蘭德	法蘭德斯
佩格尼茨	佩格尼茲
佩納姆	卑尼咸
佩萊利烏	佩里琉 貝里琉
依布拉欣	易卜拉欣
侯賽因	胡先
侯賽因·奥恩	胡先翁
俄克拉荷馬	奧克拉荷馬
俄克拉荷馬城	奧克拉荷馬城
倫巴第	倫巴底
倫弗魯	聯福
倫惇城	倫惇市
傑克孫維	積遜威爾
傑克森	積遜
先吉列伊	森吉列伊
克利福洛	克里沃羅格
克拉倫斯	嘉蘭士
克拉倫斯公園	嘉蘭士柏
克拉勒姆	克拉蘭
克拉珀姆	嘉立咸
克珀尼克	哥本尼克
克羅伊登	歌來頓
克羅伊茨貝格	十字山
克羅埃西亞	克羅地亞
克萊姆	嘉立咸
克萊德	佳德
克赤	刻赤
克里奧爾語	歸融語
克雷費爾徳	克雷費德
克馬得	克馬德克
內政和國土部	內政和家園部
內比都	奈比多
內爾斯普雷特	尼爾斯普魯特
內羅畢	內羅比
共和聯邦	英聯邦
几內亞	畿內亞
几內亞比紹	畿內亞比紹
凱可	凱科斯
凱撒勞頓	凱沙羅頓
凱撒斯勞滕	凱沙羅頓
凱瑟琳	嘉芙蓮
凱科斯	凱可
凱諾拉	肯諾拉
切斯特	車士打
切斯特勒斯特里特	切斯特勒街
切斯特菲爾德	車士打菲特
切爾滕納姆	車特咸
切爾西	車路士
切爾諾貝利	切爾諾貝爾
列支惇士登	列支惇斯登
列支惇斯登	列支惇士登
列斯伏斯	萊斯沃斯
列日	列治
利勒哈默爾	利樂漢瑪
利哈佛	勒哈弗爾
利夫奧克	活橡
利奇菲	李治菲特
利奇菲爾德	李治菲特
利恩茨	利恩茲
利斯莫爾	立斯摩爾
利曼	勒芒
利玆	列斯
利維夫	利沃夫
利隆圭	利隆威 里朗威
利雅德	利雅得
刻赤	克赤
前波美拉尼亞	西波美拉尼亞
劉易舍姆	路易咸
加彭	加蓬
加拉加斯	卡拉卡斯
加拉巴哥群島	加拉帕戈斯羣島
加沙地帶	加沙走廊
加法爾	嘉化 賈法
加法爾·巴巴	嘉化峇峇
加泰隆尼亞	加泰羅尼亞
加的夫	卡迪夫
加的斯	卡迪斯
加萊	加來
加萊海峽	加來海峽
加薩	加沙
加薩走廊	加沙走廊
努庫阿洛法	努瓜婁發
努瓜婁發	努庫阿洛法
努瓦克肖特	諾克少
努納武特	努拿烏特
努納福特	努拿烏特 努納武特
勃朗峰	白朗峰
勒布爾熱	勒布爾歇
勒拉赫	羅拉赫
勒沃庫森	利華古遜
勒阿弗爾	勒哈弗爾
勞工和社會保障部	勞動及社會事務部
勞特	魯特
包奇亞	柏嘉
北卡羅來納	北卡羅萊納
北安普惇	諾咸頓
北安普頓	諾咸頓
北部省	諾爾省
北韓離脫住民定着支援事務所	北韓離脱住民定着支援事務所
匹黎可	匹黎哥
十三個殖民地	十三殖民地
千里達及托巴哥	千里達和多巴哥
卓特咸	車特咸
南中國海	南海
南中國海礁岩	南海礁岩
南中國海礁島	南海礁島
南中國海礁石	南海礁石
南中國海礁群	南海礁羣
南北韓首腦會晤	南北韓首腦會談
南北韓高峰會	南北韓首腦會談
南卡羅來納	南卡羅萊納
南喬治亞	南佐治亞
南喬治亞和南桑威奇群島	南佐治亞及南三文治羣島
南喬治亞與南桑威奇群島	南佐治亞及南三文治羣島
南大河州	南里約格蘭州
南奧塞提亞	南奧塞梯
南安普惇	修咸頓
南桑威奇	南三文治
南澳大利亞	南澳
南澳大利亞州	南澳州
南里奧格蘭德州	南里約格蘭州
博普塔茨瓦納	波布那
博洛尼亞	波倫亞
博爾基亞	柏嘉
博爾赫隆	波格倫
博爾頓	保頓
博瑟爾	巴薩爾
博登湖	波登湖
博福爾	蒲福
博蘭	波朗
卡加延	卡加煙
卡卡頌	卡爾卡松
卡地夫	加的夫 卡迪夫
卡塞爾	卡瑟爾
卡姆登	劍頓
卡宴	皆因
卡托維玆	卡托維治
卡拉哈里沙漠	喀拉哈里沙漠
卡文	嘉弘
卡斯爾加	卡素加
卡斯特里	卡斯翠
卡斯蒂利亞	卡斯提亞
卡昂	康城
卡普里	卡布里
卡林西亞	克恩頓
卡林西亞邦	克恩頓州
卡梅爾海	卡米爾海
卡爾加里	卡加利
卡爾斯魯厄	卡斯魯厄
卡爾斯魯爾	卡斯魯厄
卡納封	加拿分
卡納溫	加拿分 卡納芬
卡納維拉爾角	卡納維爾角
卡納維爾角	卡納維拉爾角
卡納芬	加拿分
卡路什	卡盧什
卡迪夫	加的夫
卡達	卡塔爾
卡那封	加拿分 卡納芬
卡那封溫	加拿分
卡默斯	卡馬斯
印威內斯	延文禮士
危地馬拉城	危地馬拉市
厄利垂亞	厄立特里亞
厄於拉訥	愛蘭立
厄普頓	烏普頓
友誼礁	盟誼暗沙
古德伍德	高活
古拉索	庫拉索
可倫坡	科倫坡
史丹佛	施他佛
史塔克頓	士德頓
史密斯菲	士美菲
史密斯菲爾德	士美菲
史托蒙特	士多蒙
史普利特	施普利特
史普雷	施普雷
史泰利亞	施蒂利亞
史泰利亞邦	施蒂利亞州
史泰爾馬克	施泰爾馬克
史泰爾馬克邦	施泰爾馬克州
史特拉斯堡	斯特拉斯堡
史特靈	士他令
史瓦帝尼	斯威士蘭
史考茲谷	史葛斯谷
史蒂文納吉	史提芬納治
司徒加特	史特加
吉佳利	基加利
吉布地	吉布提
吉林漢姆	驕寧咸
吉爾伯頓	喬拔頓
吉爾吉斯斯坦	吉爾吉斯
吉爾福德	僑福
吉里巴斯	基里巴斯
后海灣干線	后海灣幹線
吐瓦魯	圖瓦盧
呂伐登	雷瓦登
呂北克	呂貝克
呂北克漢薩自由市	呂貝克漢薩自由市
呂德斯海姆	綠德斯翰
呂根	綠根
呂根島	綠根島
呂貝克	呂北克
哈修塔特	哈爾施塔特
哈利姆	哈林
哈利法克斯	哈利法斯
哈勒爾貝克	哈勒貝克
哈博羅內	嘉柏隆里
哈姆雷特塔	塔村
哈密	哈密德
哈密爾頓	咸美頓
哈德斯菲	哈特斯菲
哈德斯菲爾德	哈特斯菲
哈德森	哈德遜
哈林蓋	夏靈基
哈桑	哈山
哈桑納爾	哈山納
哈梅恩	哈默爾恩
哈洛	哈羅
哈爾茨	哈茲
哈爾頓	荷頓
哈特福	赫福
哈特福德	哈特福
哈瓦那	夏灣拿
哈米德	哈密德
哈米迪	哈密迪
哈義礁	南屏礁
哈芝	哈吉
哈茨山	哈茲山
哈萊克	夏力
哈薩克斯坦	哈薩克
哈雷	哈勒
哈非爾河	哈弗爾河
哈默史密斯	咸默史密夫
哥倫坡	科倫坡
哥利茲	格爾利茨
哥斯大黎加	哥斯達黎加
哥特人	哥德人
哥特堡	哥德堡
哥特字母	哥德字母
哥特式	哥德式
哥特語	哥德語
哥特風	哥德風
唐卡斯特	唐卡士打
喀斯開	喀斯喀特
喬治	佐治
喬治亞	格魯吉亞
喬治亞州	佐治亞州
喬治城	佐治城
喬治惇	佐治城
喬治斯河	佐治河
喬治王廣場	英皇佐治廣場
嘉法	賈法
因努伊特	因紐特
因弗內斯	延文禮士
因斯布魯克	茵斯布魯克
因紐特	因努伊特
國王十字	英皇十字
圖林根邦	圖林根州
圖森	土桑
圖爾	都爾
圖瓦盧	吐瓦魯
圖盧玆	圖盧茲
圖翁巴	圖文巴
圖賓根	蒂賓根
圖賴訥	都蘭
土克	特克斯
土克凱可	特克斯和凱科斯
土克凱可群島	特克斯和凱科斯羣島
土奈	圖爾奈
土庫曼斯坦	土庫曼
土爾沙	塔爾薩
土阿莫土	土亞莫土
土魯斯	圖盧茲
坎伯蘭	金巴倫
坎伯韋爾	堅伯威
坎埃克呂斯	康埃克呂斯
坎城	康城
坎布里亞	金巴倫
坎帕拉	康培拉
坎特伯里	坎特伯雷
坎盧普斯	錦祿
坎貝爾	金寶
坎貝爾惇	金寶城
坎貝爾河	金寶河
坎貝爾里弗	金寶河
坎農	景隆
坎達哈	坎大哈
坦尚尼亞	坦桑尼亞
坦布里奇韋爾斯	唐橋井
坦布里治威爾斯	唐橋井
坦干伊加	坦噶尼喀
坦米爾	泰米爾
埃克塞特	雅息特
埃因霍溫	燕豪芬
埃塞克斯	雅息士
埃夫拉塔	艾夫拉塔
埃弗拉德	愛華勒
埃弗拉德帕克	愛華勒柏
埃德蒙頓	愛民頓
埃文	雅芳
埃斯科	艾斯科
埃爾丁	艾丁
埃爾克利訥	艾克利內
埃爾斯米爾	艾斯美
埃爾朗根	埃朗根
埃爾比勒	艾比爾
埃爾特姆	愛特咸
埃爾福特	艾福特
埃爾金	伊利近
埃迪爾內	愛第尼
埃里溫	葉里温
基奇納	基秦拿
基洛沃格勒	基洛夫格勒
基洛納	基隆拿
基爾福	僑福
基督山	基度山
基耶蒂	基替
堪培拉	坎培拉
塔吉克斯坦	塔吉克
塔姆沃思	譚禾夫
塔希提	大溪地
塔拉赫西	塔拉哈西
塔斯馬尼亞	塔斯曼尼亞
塔斯馬尼亞州	塔斯曼尼亞州
塔那那利佛	安塔那那利佛
塞凡堡	塞瓦斯托波爾
塞席爾	塞舌爾
塞拉耶佛	薩拉熱窩
塞爾寇克	西谷
塞爾扣克	西谷
塞爾維亞與蒙特內哥羅	塞爾維亞和黑山
塞爾西	些路士
塞維亞	西維爾
塞維利亞	西維爾
塞蒙	塞黑
墨巴本	姆巴巴內
墨累	美利
墨西拿	美西納
士魯斯柏立	梳士貝利
夏安	夏延
夏洛滕堡	夏洛騰堡
夏洛特惇	查洛頓
夏洛特頓	查洛頓
夕利	錫利
外西凡阿爾卑斯山	南喀爾巴阡山脈
多佛爾	多佛
多塞特	多實
多多馬	杜篤瑪
多明尼加	多米尼加
多洛米蒂	多羅米提
多特蒙德	多蒙特
大不列顛及北愛爾蘭聯合王國	大不列顛暨北愛爾蘭聯合王國
大不列顛及愛爾蘭聯合王國	大不列顛暨愛爾蘭聯合王國
大本鐘	大笨鐘
大英國協	英聯邦
大陸棚	大陸架
夫利佛蘭	弗萊福蘭
夸賈林	瓜加林
奇切斯特	席車士打
奇利瓦克	智利域
奇司威克	茲錫
奇彭納姆	切柏咸
奇徹斯特	席車士打
奇西克	茲錫
奈及利亞	尼日利亞
奈梅亨	尼美根
奈比多	內比都
奈洛比	內羅比
契朋罕	切柏咸
奔薩	朋札
奧丹	奧咸
奧伊彭	歐伊朋
奧克拉荷馬市	奧克拉荷馬城
奧克維爾	屋威老
奧克蘭	屋崙
奧勒岡	俄勒岡
奧塞提亞	奧塞梯
奧巴尼	奧爾巴尼
奧弗佩爾特	奧弗佩特
奧弗涅	奧文尼
奧恩·加法尔	翁惹化
奧斯丁	柯士甸
奧斯曼	鄂圖曼
奧斯汀	柯士甸
奧斯滕德	奧斯坦德
奧斯特利茨	奧斯特里茨
奧斯特里茲	奧斯特里茨
奧斯納布呂克	奧斯納布克
奧斯納貝克	奧斯納布克
奧格斯堡	奧古斯堡
奧比斯波	奧比斯保
奧沙瓦	奧沙華
奧波列	奧波萊
奧爾巴尼	雅賓利
奧爾弗里頓	奧斐頓
奧爾德姆	奧咸
奧爾登堡	奧登堡
奧福德	俄福
奧肯拿根	奧卡拿根
奧馬	奧瑪
奧馬爾	奧瑪
奧馬魯	奧瑪魯
女王公園	昆士柏
女王大學	皇后大學
好萊塢	荷里活
姆巴巴納	墨巴本 姆巴巴內
威克菲	域菲
威塞克斯	韋息士
威廉城	威廉斯塔德
威斯康星	威斯康辛
威斯敏斯特	西敏
威斯敏斯特修道院	西敏寺
威斯敏斯特宮	西敏宮
威斯敏斯特教堂	西敏寺
威斯敏斯特聖彼得牧師團教堂	西敏市聖彼得牧師團教堂
威斯敏斯特體系	西敏制
威斯特法倫	西法倫
威明頓	威爾明頓
威根	韋根
威治	域治
威爾士	威爾斯
威爾德斯通	韋特史東
威爾特	渭州
威特沃特斯蘭德	維瓦特斯蘭
威瑟爾	韋瑟爾
威登堡	維滕貝格
孔茨	康茲
孚日	佛日
孫德爾本斯	宣德班
安克拉治	安克雷奇
安克雷奇	安克拉治
安利公園	安利柏
安古蘭	昂古萊姆
安吉拉	安圭拉
安哈拉	岩哈拉
安地卡及巴布達	安提瓜和巴布達
安地斯	安第斯
安德萊赫特	安德列治
安提阿克	安條克
安瓦爾	安華
安的列斯	安地列斯
安蒂特姆	安提頓
安達盧西亞	安達魯西亞
安那翰	安納海姆
宏都拉斯	洪都拉斯
宿務	宿霧
密德瑟斯	美度息士 美度石士
密德蘭	米德蘭
密歇根	密芝根
密爾布瑞	米爾布雷
密爾沃基	密爾瓦基
密爾瓦基	密爾沃基
密西根	密芝根
富勒姆	富咸
富勒頓	富來頓
富圖那	富圖納
富爾達	佛萊辛
寬扎	廣薩
寮人民民主共和國	老撾人民民主共和國
寮國	老撾
寮文	老撾文
寮法國保護國	老撾法國保護國
寮王國	老撾王國
寮語	老撾語
對朝政策	對北政策
小岩城	小石城
尚佩恩	香檳
尚吉巴	桑給巴爾
尚布賴萊圖爾	尚布賴萊都爾
尚比亞	贊比亞
尚貝里	香貝里
尤比亞	埃維亞
尼亞美	尼阿美
尼加拉	尼亞加拉
尼日	尼日爾
尼柯西亞	尼科西亞
尼爾堡	紐堡
尼皮辛	尼披盛
尼科平	尼雪平
尼科西亞	尼柯西亞
尼阿美	尼亞美
居斯塔維亞	古斯塔維亞
峇卡	巴卡爾
峇釐	峇里
巴丁宜阿里淺灘	南康暗沙
巴伐利亞邦	巴伐利亞州
巴休惇	巴兆惇
巴克	白加
巴內特	班列特
巴利亞利	巴利阿里
巴利亞多利德	華亞度列
巴利阿里群島	巴利亞利羣島
巴勒摩	帕勒莫
巴勒莫	巴勒摩 帕勒莫
巴卡	巴卡爾
巴塞羅那	巴塞隆拿
巴塞隆納	巴塞羅那 巴塞隆拿
巴尼特	班列特
巴布亞新几內亞	巴布亞新畿內亞
巴布亞紐幾內亞	巴布亞新畿內亞
巴布延	巴布煙
巴摩拉	巴摩盧
巴斯	巴芙
巴斯特爾	巴士地
巴斯蒂亞	巴斯提亞
巴斯通	巴斯托涅
巴新	巴紐
巴林塘	巴林坦
巴爾米拉	帕邁拉
巴爾莫勒爾	巴摩盧
巴特溪	巴特爾克里克
巴瑟斯特	巴佛士
巴符邦	巴符州
巴約訥	貝雲
巴紐	巴新
巴美拉	帕邁拉
巴西爾登	巴兆惇
巴貝多	巴巴多斯
巴赫姆特	巴赫穆特
巴達維	巴達威
巴釐	峇里
巴頓魯治	巴吞魯日
巽德班	宣德班
巽德蘭	新特蘭
布倫亨	白蘭軒
布倫來	布羅姆利
布倫海姆	白蘭軒
布吉納法索	布基納法索
布恰	布查
布拉克本	布力般
布拉卡	比立勤
布拉干	比立勤
布拉德福德	巴拉福特
布拉提斯拉瓦	布拉迪斯拉發
布拉班特	布拉邦
布拉福	巴拉福特
布拉薩	布拉柴
布拉薩市	布拉柴維爾
布林德海姆	白蘭軒
布林格蘭	兵基蘭
布根蘭	布爾根蘭
布根蘭邦	布爾根蘭州
布法羅	水牛城
布洛瓦利	布羅瓦里
布爾戈斯	布哥斯
布瓊布拉	布松布拉
布痕瓦爾德	布亨瓦德
布盧姆茨伯里	布林斯貝利
布萊克希斯	布力希斯
布萊克本	布力般
布萊克浦	黑池
布萊斯瓦利	布萊斯河谷
布萊梅	不萊梅
布萊梅港	不萊梅港
布萊梅邦	不萊梅州
布萊頓	白禮頓
布藍茲維	賓士域
布蘭岱	布蘭太爾
布蘭普頓	賓頓
布蘭登堡	勃蘭登堡
布蘭登堡邦	勃蘭登堡州
布賴頓	白禮頓
布里奇沃特	必列者窩打
布里奇波特	橋港
布里奇頓	橋鎮
布里斯托爾	布里斯托
布里斯托爾路	布里斯托路
布里斯班	布里斯本
布隆方丹	布隆泉
布雷恩垂	布倫特里
布雷根茨	布雷根茲
布靈厄蘭	兵基蘭
布魯姆斯伯里	布林斯貝利
希思羅	希斯路
希斯洛	希斯路
希沙慕丁	希山慕丁
希邁	希梅
帕丁頓	柏靈頓
帕克賽德	柏世
帕利基爾	帕里克爾
帕勞	帛琉
帕拉納	帕瑞納
帕拉馬里博	巴拉馬利波
帕瑞納	帕拉納
帕皮提	巴比提
帛琉	帕勞
干貢	甘岡
幾內亞	畿內亞
幾內亞比索	畿內亞比紹
庇里牛斯	比利牛斯
庫夫斯坦	庫夫施泰因
庫德	庫爾德
康乃狄克	康涅狄格
康伯威爾	堅伯威
康希爾	康山
康斯坦茨	康士坦茲
康樂	干諾
康沃爾	康和
康瓦爾	康和
康瓦耳	康和
康登	劍頓
康諾特	干諾
廷布	辛布
弗吉尼亞	維珍尼亞
弗林特	扶蓮
弗次瓦夫	弗羅茨瓦夫
弗爾訥	福恩
弗留利	佛里烏利
弗羅西諾內	佛羅西羅內
弗萊堡	費雷堡
弗蘭肯地區	法蘭克尼亞地區
弗蘭肯行政區	法蘭克尼亞行政區
弗賴堡	費雷堡
弗里堡	佛立堡
弗里斯蘭	菲士蘭
弗里曼特爾	費里曼圖
弗里西亞	非里西亞
弗隆特納克	芳堤娜
弗雷德里克頓	腓特烈頓
弗雷斯諾	佛雷斯諾
弗雷澤	菲沙
弗雷西內	菲瑟涅
強斯頓	約翰斯頓
強斯頓島	約翰斯頓島
強斯頓環礁	約翰斯頓環礁
彼得伯勒	彼得堡 彼德堡
彼得波羅	彼德堡
得克薩斯	德薩斯
得州	德州
得梅因	德梅因
德克薩斯	德薩斯
德凱利亞	德基利亞
德勒斯登	德累斯頓 特雷斯登
德古西加巴	特古西加爾巴
德拉瓦州	特拉華州
德拉肯斯山脈	龍山山脈
德文	德雲
德比	打比
德班	德爾班
德累斯頓	特雷斯登
德蘭士瓦	川斯瓦
德賴河	乾河
忘憂宮	無憂宮
怡朗	依路
恩加美納	恩賈梅納
恩荷芬	燕豪芬
恩菲爾德	恩菲
恩菲特	恩菲
惇克爾克	鄧寇克
惇刻爾克	鄧寇克
惇巴頓	東寶庭
惠斯勒	威士拿
惠特徹奇	韋卓
惠特沃斯	韋和夫
惠靈頓	威靈頓
惹化	賈法
惹法	賈法
愛德華茲惇	愛德華城
愛德蒙頓	愛民頓
愛森納赫	艾森納赫
愛爾朗根	埃朗根
愛爾福特	艾福特
愛蒙頓	愛民頓
慕斯達法	穆斯塔法
慕森加柏	慕遜加柏
慕豪森	米爾豪森
懷特霍斯	白馬市
戈德里奇	哥打列治
戈斯福德	高士福
戛納	康城
戛納埃克呂斯	康埃克呂斯
扎因丁	再努丁
托倫斯	多倫士
托列斯	托利斯
托彼卡	托皮卡
托斯卡納	托斯卡尼
托菲諾	吐芬奴
托萊多	托雷多
托雷斯	托利斯
托馬斯	湯瑪士
拉亞礁	光星礁
拉吉歐	拉素
拉哥斯	拉各斯
拉塞爾	羅素
拉夫伯勒	拉夫堡
拉央拉央島	彈丸礁
拉希德	拉昔
拉惹加隆淺灘	北康暗沙 義淨礁
拉斐特	拉法葉
拉斯羅普	萊思羅普
拉曼恰	拉曼查
拉特蘭	律倫
拉薩	拉扎克
拉薩克	拉扎克
拉赫曼	拉曼
拉韋洛	拉維洛
拉齊奧	拉素
拜仁邦	拜仁州
拜律特	拜洛特
拜恩邦	拜恩州
拜羅伊特	拜洛特
拿波利	拿坡里
拿督打立礁	隠波暗沙
拿索	拿騷 蘭秀
拿騷	拿索 蘭秀
提林斯	梯林斯
提比里斯	第比利斯
提洛	蒂羅爾
提洛邦	蒂羅爾州
揚德納島	延德納島
摩加迪休	摩加迪沙
摩加迪沙	摩加迪休
摩斯比	莫士比
摩斯比港	莫士比港
摩澤爾	莫瑟爾
撒丁	薩丁尼亞
敖得薩	奧迪沙 敖德薩
敖德薩	奧迪沙
數位及交通部	數碼及交通部
數字化和交通部	數碼及交通部
文丁破礁	瓊台礁
文萊	汶萊
文萊達魯薩蘭國	汶萊達魯薩蘭國
文西德爾	文西德
文達	温達
斯圖加特	史特加
斯坦福	史丹福
斯塔沃洛	斯塔弗洛
斯塔福德	施他佛
斯庫台	士科德
斯托克城	史篤城
斯托克頓	士德頓
斯托蒙特	士多蒙
斯旺西	史雲斯
斯普利特	施普利特
斯普林菲爾德	春田市
斯泰克方丹	史泰克方丹
斯泰爾	施泰爾
斯洛維尼亞	斯洛文尼亞
斯派爾	詩貝亞
斯海弗寧恩	席凡寧根
斯海爾德	須耳德
斯溫登	史雲頓
斯溫頓	史雲頓
斯潘道	施潘道
斯特拉斯堡	史特拉斯堡
斯特拉特福	史特拉福
斯特里漢姆	史卓咸
斯特里薩姆	史卓咸
斯特雷特姆	史卓咸
斯特靈	士他令
斯科普里	史高比耶
斯科茨谷	史葛斯谷
斯蒂夫尼奇	史提芬納治
斯里巴卡旺	斯里巴加灣
新不倫瑞克	紐賓士域
新几內亞	新畿內亞
新南威爾斯	新南威爾士
新南威爾斯州	新南威爾士州
新喬治亞	新佐治亞
新堡	紐卡素
新奧爾良	紐奧良
新威斯敏斯特	新西敏
新布藍茲維	紐賓士域
新布蘭斯威	紐賓士域
新帕札	新帕扎爾
新幾內亞	新畿內亞
新斯科細亞	諾華斯高沙
新斯科舍	諾華斯高沙
新沙德	諾維薩德
新港	波多諾伏
新罕布夏	新罕布什爾
新英格蘭	紐英倫
新莫斯科斯克	新莫斯科夫斯克
施泰格利茨	史泰格利茲
施洛普	史樂
施派爾	詩貝亞
施特拉爾松德	史特拉頌
施瓦本	士瓦本
施維茨	舒維茲
施蒂里亞	施蒂利亞
施蒂里亞州	施蒂利亞州
施韋因富特	什文福
施龐達勒姆	斯潘達勒姆
日占朝鮮	日佔朝鮮
日耳曼邦聯	德意志邦聯
旺多姆廣場	凡登廣場 芳登廣場
旺玆沃思	灣斯禾夫
旺茲沃斯	灣斯禾夫
旺阿玆莎	旺阿茲莎
旺阿芝莎	旺阿茲莎
昂代訥	安登
明尼亞波利斯	明尼阿波利斯
明登	棉登
昔得蘭	泄蘭
普利茅斯	普利茅夫
普勒托利亞	普勒陀尼亞
普拉亞	培亞
普林普頓	拔林惇
普林普頓帕克	拔林惇柏
普法爾茨	普法茨 普法茲
普法茲	普法爾茨
普羅斯佩克特	蒲庶庇
普萊西德湖	寧靜湖
普里斯提納	普里什蒂納
普雷史考特	皮利士葛
普雷斯科特	皮利士葛
曼哈頓	曼克頓
曼尼多巴	緬尼吐巴
曼尼托巴	緬尼吐巴 緬尼托巴
曼島	萌島
曼托瓦	曼圖亞
曼斯菲爾	曼斯菲特
曼斯菲爾德	曼斯菲特
曼特卡	曼提加
曼達納尼礁	南海礁
曼非斯	孟菲斯
朋札	奔薩
朝方	北韓方面
朝韓	南北韓
朝韓首腦會晤	南北韓首腦會談
朝鮮	北韓
朝鮮中央電視台	朝鮮中央電視台
朝鮮以及韓國	北韓以及南韓
朝鮮及韓國	北韓及南韓
朝鮮同韓國	北韓同南韓
朝鮮和韓國	北韓和南韓
朝鮮戰爭	韓戰
朝鮮文學藝朮總同盟	朝鮮文學藝術總同盟
朝鮮日占	朝鮮日佔
朝鮮獨立運動	韓國獨立運動
朝鮮與韓國	北韓與南韓
本迪戈	班迪哥
札格瑞布	薩格勒布
札法爾	賈法
札波羅熱	扎波羅熱
朱拉島	侏羅島
朴次茅斯	樸茨茅夫 樸茨茅斯
杜哈	多哈
杜塞爾多夫	杜斯多夫
杜塞道夫	杜斯多夫
杜尚貝	杜尚別
杜林	都靈
杰克遜	積遜
杰克遜維爾	積遜威爾
杰斐遜城	傑佛遜城
杰森	積遜
杰森維爾	積遜威爾
杰爾	傑爾
東加	湯加
東協	東盟
東南亞國家協會	東南亞國家聯盟
東古	東姑
東古·阿卜杜勒·拉赫曼	東姑阿都拉曼
東哥特	東哥德
東姑·阿布都拉曼	東姑阿都拉曼
東漢姆	東咸
東罕	東咸
松德里奧	桑治奧
林吉特	令吉
林茨	林茲
林茲	林茨
林雪平	林雪坪
柏京	巴金
柏寧礁	榆亞暗沙
柏林邦	柏林州
柏納比	本拿比
查化	賈法
查塔姆	漆咸
查戈斯	查哥斯
查靈	查令
柴郡	車士打郡
格來斯瓦德	格賴夫斯瓦爾德
格倫加里	己連加利
格倫奧斯蒙德	己連柯士文
格倫維爾	己連圍
格拉德斯通	格列士惇
格拉納達	格拉拿達
格拉茲	格拉茨
格林尼治	格林威治
格林貝	綠灣
格洛斯特	告羅士打
格洛瑟普	格洛索普
格溫內斯	圭內斯
格瑞那達	格林納達
格羅索普	格洛索普
格萊內爾格	己連拿奴
格蘭坪	嘉林邊
格蘭扁	嘉林邊
格里姆斯比	兼士比
桑德令罕	山靜咸
桑德蘭	新特蘭
桑德貝	雷灣
桑德靈厄姆	山靜咸
桑托斯將軍城	三投斯將軍市
梅嘉娃蒂	梅加瓦蒂
梅德斯通	美善同
梅德韋	麥德威
梅赫倫	麥赫連
棉蘭老	民答那峨
棉蘭老島	民答那峨島
楚胡伊夫	丘胡伊夫
模里西斯	毛里裘斯
樸茨茅斯	樸茨茅夫
欽奈	清奈
歐文	奧雲
歐文桑德	奧雲灣
歐文灣	奧雲灣
歐登堡	奧登堡
歐邦日	奧班吉
比亞希茲	比亞里茨
比勒費爾德	比勒菲爾德
比勒陀利亞	普勒陀尼亞
比斯凱克	比什凱克
比特	弼
比肯斯菲爾德	比更士菲
毛爾布龍	毛布朗
毛里求斯	毛里裘斯
民答那峨	棉蘭老
民答那峨島	棉蘭老島
汝拉	侏羅
汝拉山	侏羅山
汝拉州	侏羅州
汶萊和平之國	汶萊達魯薩蘭國
沃倫	華倫
沃克斯豪爾	獲素
沃克斯霍爾	獲素
沃克維爾	獲加圍
沃加沃加	華加華加
沃森維爾	華生維爾
沃爾夫斯伯格	沃爾夫斯貝格
沃爾夫斯堡	禾夫斯堡
沃爾姆斯	沃姆斯
沃爾珊斯托	窩咸史杜
沃爾瑟姆斯托	窩咸史杜
沃爾瑟姆福里斯特	窩咸森林
沃爾索爾	華素爾
沃特福德	屈福特
沃特頓	活特頓
沃索爾	華素爾
沃里克	和域
沃金頓	禾京頓
沖北岩	北嶼
沖南岩	南嶼
沙勒羅瓦	夏勒華
沙合礁	海安礁
沙吉礁	海寧礁
沙必里	沙比利
沙托魯	夏托魯
沙末	薩馬德
沙比里	沙比利
沙烏地	沙地
沙烏地阿拉伯	沙地阿拉伯
沙特	沙地
沙特阿拉伯	沙地阿拉伯
沙那	薩那
沙馬德	薩馬德
法哥	法戈
法夫	快富
法屬玻里尼西亞	法屬波利尼西亞
法恩伯勒	法恩堡
法梅恩	法梅訥
法爾斯	瓦爾斯
法爾茲	普法茨
法蘭科夫斯克	弗蘭科夫斯克
波基亞	柏嘉
波塔瓦	波爾塔瓦
波士尼亞	波斯尼亞
波士尼亞克	波什尼亞克
波士尼亞與赫塞哥維納	波斯尼亞和黑塞哥維那
波夕	博伊西
波奈	博奈爾
波德里查	波德戈里察
波昂	波恩
波札那	博茨瓦納
波爾塔瓦	波塔瓦
波爾察諾	博爾扎諾
波爾頓	保頓
波特蘭	砵蘭
波珀靈厄	波佩林厄
波登湖	博登湖
波美拉尼亞	波美恩 波莫瑞
波英	波茵
波茨坦	波茲坦
波莫瑞	波美恩
波赫	波黑
波里斯皮爾	鮑里斯皮爾
波隆納	波倫亞
泰因	泰恩
泰益·馬哈茂德	泰益瑪目
洛蒙	露明
洛蒙德	露明
洛迪	洛戴
派丁頓	柏靈頓
海格特	海機治
海爾布隆	海布隆
海馬礁	南安礁
淡米爾	泰米爾
深圳灣	后海灣
溫切斯特	温車士打
溫尼伯	温尼辟
溫布利	温布萊
溫布爾登	温布頓
溫得和克	温荷克
溫徹斯特	温車士打
溫特沃斯	温特窩夫
滑鐵盧	窩打老
漢密爾頓	咸美頓
漢彌爾頓	咸美頓
漢斯	蘭斯
漢普	衡州
漢普頓	咸頓
漢米頓	咸美頓
漢默史密斯	咸默史密夫
澤凱利亞	德基利亞
澳大利亞	澳洲
澳大利亞聯邦	澳洲聯邦
火奴魯魯	檀香山
烏姆	烏爾姆
烏帕塔	烏帕塔爾
烏得勒支	烏德勒支
烏比烏比礁	光星仔礁
烏特勒支	烏德勒支
烏玆別克斯坦	烏茲別克
烏赫爾	烏格爾
烏隆地	烏隆迪
焦爾	傑爾
熱納普	日內普
特倫提諾	特倫蒂諾
特倫特河畔斯托克	特倫特河畔史篤
特倫甘納	泰倫加納
特克斯	土克
特克斯和凱科斯	土克凱可
特克斯和凱科斯群島	土克凱可羣島
特古西加爾巴	德古西加巴
特威德	陶域
特普利釆	特普利策
特立尼達和多巴哥	千里達及托巴哥 千里達和多巴哥
特羅布里奇	措必列治
特華	特魯華
特蘭斯凱	川斯凱
特諾皮爾	捷爾諾波爾
特雷爾	始路
特雷西	翠絲
特魯瓦	特魯華
狄力	帝力
狄蒙	德梅因
狼堡	沃爾夫斯堡 禾夫斯堡
猶加惇	尤卡坦
獅子山	塞拉利昂
獨立國協	獨聯體
玻里尼西亞	波利尼西亞
珀斯	巴富
班來	般尼
班吉	班基
班布里奇	班布里治
班珠爾	班竹
琳吉礁	法顯暗沙
瓜地洛普	瓜德羅普
瓜地馬拉	危地馬拉
瓜地馬拉市	危地馬拉市
瓜達康納爾	瓜達爾卡納爾
瓦倫西亞	華倫西亞
瓦加杜古	烏格都古
瓦加瓦加	華加華加
瓦哈比	瓦哈
瓦拉多利德	華亞度列
瓦斯卡納	華斯卡拿
瓦杜玆	華杜茲
瓦爾珊森林	窩咸森林
瓦爾訥通	瓦內頓
瓦特福	屈福特
瓦特頓	活特頓
瓦茨曼	瓦茲曼
瓦萊塔	瓦勒他
瓦都茲	華杜茲
瓦隆	華隆
瓦隆尼亞	華隆尼亞
甘比亞	岡比亞
甘露	錦祿
甘馬仁	甘馬粦
申根	神根
申根公約	神根公約
申根協議	神根公約
留尼汪	留尼旺
畢爾巴鄂	畢爾包
發羅拉	夫羅勒
白石灘	澄平礁
百慕大	百慕達
皮姆利科	匹黎哥
皮特凱恩	皮特肯
盧塞恩	琉森
盧安達	盧旺達
盧昂	魯昂
盧比安納	盧布爾雅那
盧薩卡	路沙卡
石勒蘇益格	什列斯威
硅谷	矽谷
社本	謝爾本
祖格峰	楚格峰
福弗爾	科發
福拉爾貝格邦	福拉爾貝格州
福爾特	菲爾特
禾夫斯堡	沃爾夫斯堡
科克倫	閣倫
科布倫茨	科布倫茲
科斯雷	庫賽埃
科爾伍德	高活
科爾切斯特	高車士打
科爾多瓦	哥多華
科爾察	科赤
科爾蒂納丹佩佐	柯蒂納戴比索
科特賴克	科特里克
科珀斯克里斯蒂	聖體市
科米訥	科敏
科納克里	柯那克里
科羅拉多斯普林斯	科羅拉多泉
科羅爾	柯羅
科羅納多	嘉拿多
科芬特里	高雲地利
科赤斯特	高車士打
科隆群島	加拉帕戈斯羣島
穆希丁	慕尤丁
穆斯喬	穆斯佐
穆爾西亞	莫夕亞 莫西亞
突尼斯	突尼西亞
端古·賽義德·西拉杰丁	端姑賽義德·西拉杰丁
端姑賽西拉如丁	端姑賽義德·西拉杰丁
端姑賽西拉祖丁	端姑賽義德·西拉杰丁
符拉迪沃斯托克	海參崴
符茲堡	維爾茨堡
第厄普	迪耶普
第聶伯羅	第尼伯
第聶伯羅彼得羅夫斯克	第尼伯彼得羅夫斯克
策提涅	釆蒂涅
策林根	哲林根
米占	米詹
米占·再納·阿比丁	米詹·扎因·阿比丁
米占再納阿比丁	米詹·扎因·阿比丁
米德斯堡	米杜士堡
米德爾塞克斯	美度息士 美度石士
米德爾斯伯勒	米杜士堡
米德爾斯堡	米杜士堡
米沙鄢	維薩亞斯
米沙鄢人	維薩亞人
米爾果羅德	米爾哥羅德
米爾豪森	慕豪森
米爾頓	苗頓
約克郡	約郡
約塞米蒂	優勝美地
約納河	約訥河
約納省	約訥省
約翰內斯堡	約翰尼斯堡
納什維爾	納士維
納卯市	達沃市
納吉布	納吉
納奈莫	乃磨
納帕尼	納潘尼
納戈爾諾卡拉巴赫	納戈爾諾
納木爾	那慕爾
納次福	諾士佛
納沙泰爾	紐沙特
納瓦拉	納華拉
納茨福德	諾士佛
納蒂靈	尼德寧
納言	納哈揚
納許維爾	納士維
紐卡斯爾	紐卡素
紐卡索	紐卡素
紐沙特	納沙泰爾
紐波特	新港
紐漢	紐咸
紐澤西	新澤西
紐華克	紐瓦克
紐西蘭	新西蘭
索倫托	蘇連多
索利赫爾	梳利侯
索斯蓋特	修夫基
索爾玆伯里	梳士巴利
索爾茲伯里	梳士巴利
索美塞	森麻實
索美塞特	森麻實
索茲伯里	梳士巴利
索韋托	索維托
索頓	薩頓
索馬利亞	索馬里
索馬利蘭	索馬里蘭
累西腓	勒西菲
紹曾德奧克斯	千橡
經濟合作與發展部	經濟合作及發展部
經濟和氣候保護部	經濟事務和氣候行動部
維也納邦	維也納州
維京	處女
維京群島	處女羣島
維吉尼亞	維珍尼亞
維奇	域治
維岡	韋根
維希	維琪
維德角	佛得角
維根	韋根
維爾京	處女
維爾京群島	處女羣島
維特沃斯	韋和夫
維特祖治	韋卓
緬尼托巴	曼尼托巴
羅亞爾河	盧瓦爾河
羅亞羅克桑斯	盧瓦羅克桑斯
羅奇代爾	羅慈地
羅安達	魯安達
羅得島	羅德島
羅得西亞	羅德西亞
羅梭	羅索
羅瑟勒姆	洛達咸
羅索	羅梭
羅里	羅利
美加華蒂	梅加瓦蒂
美因	美茵
美因茨	緬恩斯 美因茲 美茵茲
美因茲	緬恩斯
美巴蒂灘	歡樂暗沙
美景市	比路賀利桑特
美西納	墨西拿
義屬	意屬
義屬利比亞	意屬利比亞
義屬索馬利	意屬索馬里
翁布里亞	温布利亞
翠登	特倫頓
老安道爾	安道爾城
考文垂	高雲地利
考納斯	考那斯
耶也	葉海亞
耶哈也	葉海亞
耶洛奈夫	黃刀鎮
耶羅納夫	黃刀鎮
耶谷	雅柯布
聖伯納迪諾	聖班納甸奴
聖何塞	聖何西
聖克拉拉	聖塔克拉拉
聖克里斯多福及尼維斯	聖基茨和尼維斯
聖勞倫斯	聖羅倫斯 聖老楞佐
聖地亞哥	聖地牙哥
聖地牙哥	聖地亞哥
聖基茨和尼維斯	聖克里斯多福及尼維斯
聖塔菲	聖菲 聖達菲
聖多明各	聖多明哥
聖多明哥	聖多明各
聖多美和普林西比	聖多美普林西比
聖多美普林西比	聖多美和普林西比
聖尤斯特歇斯	聖佑達修斯
聖巴勃羅	聖帕布羅
聖巴瑟米	聖巴泰勒米
聖彼得斯	聖彼得
聖德田	聖伊天
聖文森及格瑞那丁	聖文森特和格林納丁斯
聖波爾坦	聖帕爾滕
聖海蓮娜	聖海倫娜
聖特賴登	聖楚登
聖珀爾滕	聖帕爾滕
聖皮耶	聖皮埃爾
聖皮耶與密克隆	聖皮埃爾和密克隆
聖羅莎	聖羅沙
聖艾蒂安	聖伊天
聖荷西	聖何西
聖菲	聖塔菲 聖達菲 聖非
聖詹姆士	聖占士
聖詹姆斯	聖占士
聖貝納迪諾	聖班納甸奴
聖赫勒拿	聖海倫娜
聖路易	聖路易斯
聖迭戈	聖地亞哥
聖馬利諾	聖馬力諾
聖馬力諾	聖馬利諾
聖馬特奧	聖馬刁
聯邦信息處理標准	聯邦資料處理標準
聶伯	第聶伯
聶伯城	第聶伯羅 第聶伯羅彼得羅夫斯克
聶斯特	德涅斯特
肯亞	肯尼亞
肯尼茲	真尼沙
肯特	根德
臺夫特	代爾夫特
興都教	印度教
舊金山	三藩市
舍伯恩	謝爾本
舒維茲	施維茨
舒茲伯利	什魯斯伯里
艾伯塔	亞伯達
艾伯特	亞厘畢
艾厄士米爾	艾斯美
艾哈邁德	阿末
艾塞克斯	雅息士
艾奧瓦	愛荷華
艾希特	雅息特
艾恩德霍芬	燕豪芬
艾爾姆胡爾特	阿姆霍特
艾珊	愛特咸
艾瑟爾	愛塞
艾肯礁	義淨礁
艾薩	伊薩
艾霍蘭	上荷蘭
艾麗斯斯普林斯	愛麗斯泉
芒廷維尤	山景城
芒特巴克	白加山
芒特甘比爾	甘比爾山
芒特艾薩	伊薩山
芝華塔尼歐	斯華坦尼奧
芬斯伯里	芬士巴利
芬斯伯雷	芬士巴利
芳登廣場	凡登廣場
英吉利海峽	英倫海峽
英屬哥倫比亞	卑詩
英戈爾施塔特	因戈施塔特
茅利塔尼亞	毛里塔尼亞
茨欣瓦利	茲辛瓦利
茨維考	茲維考
茲威考	茲維考
茹埃萊圖爾	茹埃萊都爾
荷屬安的列斯	荷屬安地列斯
荷巴特	荷伯特
莫三比克	莫桑比克
莫哈末	穆罕默德
莫夕亞	莫西亞
莫德伯里	摩保利
莫桑比克	莫三比克
莫洛尼	莫羅尼
莫爾文	茂路凡
莫爾斯比	摩斯比 莫士比
莫爾斯比港	莫士比港
莫策爾	摩策爾
莫迪礁	康西暗沙
莫道克	梅鐸
莫里	慕禮
莫雷阿島	茉莉亞島
華合	瓦哈
華威	和域
菲尼克斯	鳳凰城
菲尼克斯群島	鳳凰羣島
菲希特爾山	費希特山
菲德里克	弗雷德里克
萊斯特	李斯特
萊斯里普	雷士廉
萊普邦	萊普州
萊法邦	萊法州
萊波薩維齊	萊波薩維奇
萊特島	雷伊泰島
萊特灣	雷伊泰灣
萊特省	雷伊泰省
萊茵蘭	萊因蘭
萊蒙格羅韋	檸檬林
萊西訥	列辛
萬·阿齐扎	旺阿茲莎
萬年煙礁	潭門礁
萬象	永珍
萬那杜	瓦努阿圖
落基	洛磯
落磯	洛磯
葉門	也門
葛摩	科摩羅
葛蘭蓋瑞	己連加利
蒂特里加利	茶樹涌
蒂頓	提頓
蒙哲臘	蒙特塞拉特
蒙彼利埃	蒙佩利爾 蒙皮立
蒙得維的亞	蒙特維多
蒙特佩利爾	蒙彼利埃
蒙特內哥羅	黑山
蒙特利爾	滿地可 蒙特婁
蒙特塞拉特	蒙哲臘
蒙特婁	滿地可
蒙特瑞	蒙特雷
蒙皮立	蒙彼利埃
蒙茅斯	萬茂
蒲隆地	布隆迪
蓋威克	格域
蓋特威克	格域
蓋茨黑德	格士黑德
蓋茲赫德	格士黑德
薩丁尼亞	撒丁
薩克其萬	沙斯卡寸旺
薩克拉門托	沙加緬度
薩克森邦	薩克森州
薩塞克斯	修適士
薩安邦	薩安州
薩尼亞	沙尼亞
薩尼奇	沙尼治
薩巴	荷屬沙巴
薩德伯里	瑟比利
薩拉戈薩	沙拉哥薩
薩拉熱窩	塞拉耶佛
薩拉赫丁	沙拉胡丁
薩斯卡渣文	沙斯卡寸旺
薩斯卡通	沙斯加通
薩斯喀屯	沙斯加通
薩斯喀徹溫	沙斯卡寸旺
薩斯奎漢納	薩斯奎哈納
薩爾布呂肯	薩爾布魯根
薩爾斯堡邦	薩爾斯堡州
薩爾特河	薩特河
薩爾特省	薩特省
薩爾茨堡	薩爾斯堡
薩爾茨堡州	薩爾斯堡州
薩爾蘭邦	薩爾蘭州
薩爾邦	薩爾州
薩瑟克	南華克
薩瑟蘭	修打蘭
薩福克	沙福
薩萊諾	薩雷諾
薩蒙阿姆	沙問暗
薩赫爾	薩赫勒
薩那	沙那
薩里	舒梨
薩默塞特	森麻實
藍色海岸	蔚藍海岸
蘇伊士	蘇彞士
蘇伊士運河	蘇彞士運河
蘇克雷	蘇克瑞
蘇加諾	蘇卡諾
蘇哈多	蘇哈托
蘇必利爾	蘇必略
蘭卡斯特	蘭加士打
蘭喬科爾多瓦	科多瓦牧場
蘭茨胡特	蘭休特
蘭貝斯	琳寶
蘭開斯特	蘭加士打
衛氏朝鮮	衞氏朝鮮
衛滿朝鮮	衞滿朝鮮
衣索比亞	埃塞俄比亞
西伐利亞	西法倫
西利西亞	西里西亞
西南非洲	西南非
西哥特	西哥德
西密卡米恩	西米卡綿
西布礁	簸箕礁
西拉如丁	西拉杰丁
西拉祖丁	西拉杰丁
西斯凱	希斯凱
西漢姆	韋斯咸
西澳大利亞州	西澳州
西發利亞	西法倫
西罕	韋斯咸
訥沙托	紐沙特
訥沙泰勒	紐沙特
訥韋爾	尼維爾
設得蘭	昔德蘭 泄蘭
設德蘭	昔德蘭 泄蘭
詹姆士	占士
詹姆士暗沙	曾母暗沙
詹姆斯	占士
諾丁漢	諾定咸
諾丁罕	諾丁漢 諾定咸
諾伊馬克特	紐馬赫
諾伍德	諾活
諾威治	諾域治
諾曼底	諾曼第
諾瓦斯科舍	諾華斯高沙
諾里奇	諾域治
諾魯	瑙魯
謝菲爾德	錫菲
謝赫·穆扎法尔	錫慕查化
譚沃思	譚禾夫
讓布盧	戎布魯
象牙海岸	科特迪瓦
豪恩斯洛	豪士羅
貝傑拉克	貝爾熱拉克
貝克島	必嘉島
貝克街	必嘉街
貝南	貝寧
貝司蘭	別斯蘭
貝夫諾格林	貝夫農綠地
貝德福	百福
貝德福德	百福
貝思納爾綠地	貝夫農綠地
貝洛奧里藏特	比路賀利桑特
貝洛納	貝羅那
貝爾格勒	貝爾格萊德
貝爾維尤	柏衞
貝爾莫潘	貝爾墨邦
貝爾訥姆	貝爾嫩
貝肯翠	碧勤翠
貝里斯	伯利茲
貝隆納	貝羅那
貝靈恩	白令根
貢比涅	康比涅
費爾特姆	費特咸
賓夕法尼亞	賓夕凡尼亞
賓茨	賓茲
賴比瑞亞	利比里亞
賴索托	萊索托
賴興瑙	萊赫瑙
賴謝瑙	萊赫瑙
賽夫	賽義夫
賽慕查化	錫慕查化
賽普勒斯	塞浦路斯
賽益	薩伊德
賽義德	薩伊德
赤斯特街	切斯特勒街
赤斯特非	車士打菲特
赫內	黑爾訥
赫塞哥維納	黑塞哥維那
赫拉克勒斯	海克力斯
赫爾河	侯河
赫爾河畔京斯惇	侯城
赫爾河畔金斯惇	侯城
赫特福德	赫福
赫瑞福	禧福 赫福
赫羅納	基羅納
赫里福德	禧福
路易士港	路易港
路易斯罕	路易咸
路易港	路易士港
車尼夫契	切爾諾夫策
車諾比	切爾諾貝爾
辛巴威	津巴布韋
辛菲羅波爾	辛菲洛普
辛費羅波爾	辛菲羅波爾
迪克斯邁德	迪克斯木德
迪凱特	第開特
迪勃拉	第巴爾
迪爾多夫	迪爾道夫
通托維	湯多威
道森克里克	多臣隙
道森河	多臣隙
道菲	陶菲克
道里	道裏
道里區	道裏區
達佛	達爾富爾
達勒姆	對衡 德罕
達喀爾	達卡
達姆施塔特	達姆城
達弗林	德芙靈
達拉謨	對衡
達根罕	杜根咸
達格納姆	杜根咸
達爾豪斯	戴爾豪斯
達累斯薩拉姆	三蘭港
達豪	達浩
達雅克	達雅
邁阿密	邁亞密
那不勒斯	拿坡里
那米比亞	納米比亞
鄧巴	登巴
鄧巴頓	東寶庭
鄧肯	黨近
鄧迪	登地
鄧達斯	登打士
釆倫多夫	釆倫道夫
里士滿	列治文
里奇蒙	列治文
里希坦伯格	利希滕貝格
里朗威	利隆威
里東礁	北安礁
里耳	里爾
里茲	列斯
里賈納	利載拿
金夏沙	金沙薩
金奈	清奈
金斯惇	京士惇 京士頓
金斯頓	京士頓
金石城	京士頓
釣魚島	釣魚台
釣魚島及其附屬島嶼	釣魚台及其附屬島嶼
釣魚臺	釣魚台
釣魚臺列嶼	釣魚台及其附屬島嶼
錫姆科	閃高
錫巴頓	非百惇
錫德納姆	薛鄧咸
錫根	席根
錫格堡	希格堡
錫格馬林根	西格馬林根
錫瓦塔內霍	斯華坦尼奧
錫耶納	西恩納
錫里斯	席瑞絲
門洛帕克	門洛公園
門興格拉德巴赫	慕遜加柏
開姆尼茨	真尼沙
開雲	皆因
阿什哈巴特	阿什哈巴德
阿什福德	亞士霍
阿什莫爾和卡捷	亞什摩及卡地爾
阿伯丁	鴨巴甸
阿伯尼	雅賓利
阿伯茨福德	亞博斯福
阿倫	鴉蘭
阿克提卡	奧赫蒂爾卡
阿克羅蒂里	阿克魯帝利
阿克羅蒂里和澤凱利亞	亞克羅提利與德凱利亞 阿克魯帝利及德基利亞
阿克頓	厄頓
阿卜杜勒-阿齊玆	阿卜杜勒-阿齊茲
阿卜杜勒·拉希姆	阿都拉欣
阿卜杜勒·拉扎克	阿都拉薩
阿卜杜勒·拉赫曼	阿都拉曼
阿卜杜勒·阿齊玆	阿卜杜勒·阿齊茲
阿卜杜拉·巴達維	阿卜杜拉·巴達威
阿卜耶伊	艾卜耶
阿因維克	安域
阿基坦	亞奎丹
阿塔卡馬	阿他加馬
阿姆哈拉	岩哈拉
阿姆斯特朗	暗士黨
阿姆胡特	阿姆霍特
阿威	阿爾維
阿密達	阿米代爾
阿布·巴卡爾	阿布巴卡爾
阿布加	阿布賈
阿布奎基	阿爾伯克基
阿布峇卡	阿布巴卡爾
阿布巴卡	阿布巴卡爾
阿布達比	阿布扎比
阿布都	阿卜杜勒
阿布都-阿濟茲	阿卜杜勒-阿齊茲
阿布都·阿濟茲	阿卜杜勒·阿齊茲
阿布都拉	阿卜杜拉
阿布都拉·巴達威	阿卜杜拉·巴達威
阿布都拉曼	阿都拉曼
阿得雷德	阿德萊得 阿德萊德
阿德萊德	阿德萊得
阿必尚	阿比讓
阿拉伯埃及共和國	埃及阿拉伯共和國
阿拉伯聯合大公國	阿拉伯聯合酋長國
阿拉姆	阿蘭
阿拉巴馬	亞拉巴馬
阿拉梅達	阿拉米達
阿拉貢	亞拉岡
阿斯馬拉	阿斯瑪拉
阿方索克勞迪烏	亞豐素克勞迪烏
阿比路	艾比路
阿濟茲	阿齊茲
阿爾伯塔	亞伯達
阿爾伯特	亞厘畢
阿爾勒	亞爾
阿爾戈納	阿哥納
阿爾梅勒	阿梅爾
阿爾派恩	阿爾卑斯
阿爾薩斯	亞爾薩斯
阿爾費爾德	阿費爾德
阿特沃特	艾特瓦特
阿玆	阿齊茲
阿玆敏	阿茲敏
阿玆莎	阿茲莎
阿玆蘭	阿茲蘭
阿登	亞爾丁
阿登森林	亞爾丁森林
阿皮亞	阿庇亞
阿省	亞省
阿納海姆	安納海姆
阿維尼翁	亞維農
阿聯	阿聯酋
阿育	阿尤布
阿芝莎	阿茲莎
阿蓋爾	亞皆老
阿訥西	安錫
阿迪斯阿貝巴	亞的斯亞貝巴
阿都	阿卜杜勒
阿都·拉欣	阿都拉欣
阿都·拉薩	阿都拉薩
阿都拉	阿卜杜拉
阿都拉·巴達威	阿卜杜拉·巴達威
阿都阿玆	阿卜杜勒-阿齊茲
阿都阿玆	阿卜杜勒·阿齊茲
阿都馬力	阿卜杜勒·馬利克
阿順礁	海康暗沙
阿風索克勞迪歐	亞豐素克勞迪烏
阿馬爾菲	阿瑪菲
阿齊扎	阿茲莎
阿齊玆	阿齊茲
陶爾哈姆萊茨	塔村
隆河	羅訥河
隆河新堡	羅訥新堡
隆河省	羅訥省
隆達省	倫達省
隱波暗沙	隠波暗沙
雀西	翠絲
雅也	葉海亞
雅各布	雅柯布
雅恩德	雅温得
雅爾塔	雅爾達
雅耶	葉海亞
雅連	亞倫
雪柏	謝潑德
雪梨	悉尼
雪菲爾	錫菲
雷伊泰島	雷伊泰灣
雷克斯漢姆	域斯咸
雷克瑟姆	域斯咸
雷克雅維克	雷克雅未克
雷吉納	利載拿
雷德伍德城	紅木城
雷德布里奇	紅橋
雷格尼茨河	雷格尼茲河
霍夫	荷甫
霍尼亞拉	荷尼阿拉
霍巴特	荷伯特
霍爾斯坦	荷爾斯泰因
霍赫斯特拉滕	胡格斯特拉頓
韋克菲爾德	域菲 域菲路
韋斯特比奇	西灘
韋爾登拉特	威登拉特
韋爾維耶	弗威耶
韋爾菲克	威維克
韋維爾	威埠
韋茨拉爾	威茲拉爾
韓國	南韓
韓國以及朝鮮	南韓以及北韓
韓國及朝鮮	南韓及北韓
韓國同朝鮮	南韓同北韓
韓國和朝鮮	南韓和北韓
韓國科學技朮院	韓國科學技術院
韓國與朝鮮	南韓與北韓
韓方	南韓方面
韓裔	南韓裔
頓內次	頓涅茨
頓內次克	頓涅茨克
頓內茨克	頓涅茨克
飛瀨	飛嶼
食品和農業部	食品及農業部
馬丁內斯	馬丁尼茲
馬丁尼克	馬提尼克
馬什	馬爾什
馬來西亞總理	馬來西亞首相
馬卡蒂	馬卡迪
馬哈地	馬哈迪
馬哈蒂爾	馬哈迪
馬塞盧	馬賽魯
馬尼圖林	緬尼圖連
馬恩島	萌島
馬拉威	馬拉維
馬拉維	馬拉威
馬斯垂克	馬斯特里赫特
馬斯河	馬士河
馬普托	馬布多
馬末	馬哈茂德
馬朱羅	馬久羅
馬格德堡	馬德堡
馬爾他	馬耳他
馬爾凱	馬凱
馬爾地夫	馬爾代夫
馬爾默	馬爾摩
馬耳他	馬爾他
馬薩諸塞	麻薩諸塞
馬薩諸塞州	麻省
馬那瓜	馬納瓜
馬里亞納	馬利安納
馬里蘭	馬利蘭
馬魯古	摩鹿加
魏爾堡	威爾堡
魏瑪	威瑪
魯安達	羅安達
魯梅爾斯堡	魯梅斯堡
鯨灣港	華維斯灣
麥克墨雷	麥梅利
麥克默里	麥梅利
麥吉爾	麥基爾
麥納麥	麥納瑪
麥考瑞	麥覺理
麻六甲	馬六甲
麻薩諸塞州	麻省
黑斯廷斯	喜士定
黑林山	黑森林
黑森邦	黑森州
黑潭	黑池
黑爾舍姆	海爾斯罕
默塞德	美熹德
