万·阿齐扎	旺阿兹莎
万茂	蒙茅斯
万象	永珍
万那杜	瓦努阿图
三兰港	达累斯萨拉姆
三投斯将军市	桑托斯将军城
三藩市	旧金山
上伏塔	上沃尔特
上哈兹	上哈尔茨 上哈茨
上奥地利邦	上奥地利州
上荷兰	艾霍兰
下奥地利邦	下奥地利州
下萨克森邦	下萨克森州
不列颠哥伦比亚	卑诗
不来梅	不莱梅
不来梅州	不莱梅州
不莱梅	不来梅
不莱梅港	不来梅哈芬
东加	汤加
东协	东盟
东南亚国家协会	东南亚国家联盟
东古	东姑
东古·阿卜杜勒·拉赫曼	东姑阿都拉曼
东咸	东汉姆
东哥德	东哥特
东姑·阿布都拉曼	东姑阿都拉曼
东宝庭	邓巴顿
东罕	东汉姆
丹地	邓迪
丹帕沙	登巴萨
主权根据地区	主权基地区
乃磨	纳奈莫
义净礁	艾肯礁
义属	意属
义属利比亚	意属利比亚
义属索马利	意属索马里
乌兹别克	乌兹别克斯坦
乌姆	乌尔姆
乌帕塔	伍珀塔尔
乌帕塔尔	伍珀塔尔
乌帕河	伍珀河
乌德勒支	乌得勒支
乌普顿	厄普顿
乌格尔	乌赫尔
乌格都古	瓦加杜古
乌特勒支	乌得勒支
乌隆地	乌隆迪
乔拔顿	吉尔伯顿
乔治亚	格鲁吉亚
乔治亚州	佐治亚州
乔治城	乔治敦
亚丰素克劳迪乌	阿方索克劳迪乌
亚什摩及卡地尔	阿什莫尔和卡捷
亚他加马	阿塔卡马
亚伯丁	阿伯丁
亚伯达	艾伯塔 阿尔伯塔
亚克罗提利与德凯利亚	亚克罗提利和德凯利亚 阿克罗蒂里和泽凯利亚
亚博斯福	阿伯茨福德
亚历山卓	亚历山大港
亚厘毕	阿尔伯特
亚塞拜然	阿塞拜疆
亚士霍	阿什福德
亚奎丹	阿基坦
亚尔	阿尔勒
亚尔丁	阿登
亚尔丁森林	阿登森林
亚尔萨斯	阿尔萨斯
亚拉冈	阿拉贡
亚本塞	阿彭策尔
亚森欣	阿森松
亚沃利夫	亚沃里夫
亚皆老	阿盖尔
亚省	阿省
亚细安	东盟
亚细安组织	东南亚国家联盟
亚维农	阿维尼翁
亚辛	雅欣
亚速群岛	亚速尔群岛
亚雅	耶也 耶哈也
亚雅	雅也 雅耶
亚马逊	亚马孙
些路士	塞尔西
京士敦	金斯敦
京士顿	金斯敦 金斯顿
京斯敦	金斯敦
京斯顿	金斯敦 金斯顿
什列斯威	石勒苏益格
什勒斯维希	石勒苏益格
什文福	施韦因富特
什霍邦	石荷州
伊令	伊灵
伊伯	伊珀尔
伊凡	伊万诺
伊凡诺	伊万诺
伊利沙伯港	伊丽莎白港
伊利诺	伊利诺伊
伊利近	埃尔金
伊南克洛	伊纳姆克洛
伊布拉欣	依布拉欣
伊斯兰玛巴德	伊斯兰堡
伊斯坦布尔	伊斯坦堡
伊斯林顿	伊斯灵顿
伊斯梅尔	依斯迈
伊普斯威奇	伊普斯维奇
伊比利	伊比利亚
伊瓦诺	伊万诺
伊莉莎白港	伊丽莎白港
伊萨	艾萨
伊萨山	芒特艾萨
伊魁特	伊卡卢伊特
伏林	沃伦
休士顿	休斯敦 休斯顿
休斯敦	休斯顿
优胜美地	约塞米蒂
伦巴底	伦巴第
伦敦城	伦敦市
伦达省	隆达省
伯恩	伯尔尼
伯斯	珀斯
伯明罕	伯明翰
佐治	乔治
佐治城	乔治敦
佐治河	乔治斯河
佛伊弗迪纳	伏伊伏丁那
佛兰德	法兰德斯
佛德州	沃州
佛拉蒙	弗拉芒
佛日	孚日
佛立堡	弗里堡
佛罗伦斯	佛罗伦萨
佛罗西罗内	弗罗西诺内
佛茨海姆	普福尔茨海姆
佛莱明	弗拉芒
佛莱辛	富尔达
佛里乌利	弗留利
佛雷斯诺	弗雷斯诺
佩格尼兹	佩格尼茨
佩里琉	佩莱利乌
佳德	克莱德
侏罗	汝拉
侏罗山	汝拉山
侏罗岛	朱拉岛
侏罗州	汝拉州
依路	伊洛伊洛
侨福	吉尔福德
侯城	赫尔河畔金斯敦
侯斯顿	休斯敦 休斯顿
侯河	赫尔河
侯赛因	胡先
侯赛因·奥恩	胡先翁
俄福	奥福德
保顿	博尔顿
修咸顿	南安普敦
修夫基	索斯盖特
修打兰	萨瑟兰
修适士	萨塞克斯
光星仔礁	乌比乌比礁
光星礁	拉亚礁
克利福洛	克里沃罗格
克拉兰	克拉勒姆
克罗埃西亚	克罗地亚
克莱姆	克拉珀姆
克赤	刻赤
克雷费德	克雷费尔德
克马得	克马德克
党近	邓肯
兰休特	兰茨胡特
兰加士打	兰开斯特
兰卡斯特	兰开斯特
兰秀	拿骚
兵基兰	布灵厄兰
兹威考	茨维考
兹维考	茨维考
兹辛瓦利	茨欣瓦利
兹锡	奇司威克
兼士比	格里姆斯比
内政和家园部	内政和国土部
内罗比	内罗毕
冲北岩	北屿
冲南岩	南屿
几内亚比索	几内亚比绍
凡登广场	旺多姆广场
凤凰群岛	菲尼克斯群岛
凯可	凯科斯
凯撒劳顿	凯撒斯劳滕
凯沙罗顿	凯撒斯劳滕
切尔诺贝尔	切尔诺贝利
切斯特勒街	切斯特勒斯特里特
切柏咸	奇彭纳姆
列支敦斯登	列支敦士登
列斯	利兹
列斯伏斯	莱斯沃斯
列治	列日
列治文	里士满
列辛	莱西讷
利乐汉玛	利勒哈默尔
利华古逊	勒沃库森
利哈佛	勒阿弗尔
利奇菲	利奇菲尔德
利恩兹	利恩茨
利曼	勒芒
利维夫	利沃夫
利载拿	里贾纳
利隆威	利隆圭
利雅德	利雅得
剑顿	卡姆登
加彭	加蓬
加拉巴哥群岛	科隆群岛
加拉帕戈斯群岛	科隆群岛
加拿分	卡纳温 卡那封
加沙走廊	加沙地带
加法尔	嘉化 嘉法
加法尔	惹化 惹法 查化
加法尔·巴巴	嘉化峇峇
加泰隆尼亚	加泰罗尼亚
加的夫	卡迪夫
加莱	加来
加莱海峡	加来海峡
加萨	加沙
加萨走廊	加沙地带
努拿乌特	努纳武特
努瓜娄发	努库阿洛法
努纳福特	努纳武特
劳动及社会事务部	劳工和社会保障部
勒哈弗尔	勒阿弗尔
勒布尔热	勒布尔歇
勒西菲	累西腓
包奇亚	波基亚
北卡罗莱纳	北卡罗来纳
北安普敦	北安普顿
北安礁	里东礁
北康暗沙	拉惹加隆浅滩
北韩离脱住民定著支援事务所	北韩离脱住民定着支援事务所
匹黎可	皮姆利科
匹黎哥	皮姆利科
十三殖民地	十三个殖民地
十字山	克罗伊茨贝格
千橡	绍曾德奥克斯
千里达及托巴哥	特立尼达和多巴哥
千里达和多巴哥	特立尼达和多巴哥
华亚度列	巴利亚多利德
华伦	沃伦
华伦西亚	瓦伦西亚
华加华加	瓦加瓦加
华威	沃里克
华斯卡拿	瓦斯卡纳
华杜兹	瓦杜兹
华生维尔	沃森维尔
华素尔	沃尔索尔
华维斯湾	鲸湾港
华隆	瓦隆
华隆尼亚	瓦隆尼亚
卑尼咸	佩纳姆
卑诗	不列颠哥伦比亚
卓特咸	切尔滕纳姆
南三文治	南桑威奇
南乔治亚与南桑威奇群岛	南乔治亚和南桑威奇群岛
南佐治亚	南乔治亚
南佐治亚及南三文治群岛	南乔治亚和南桑威奇群岛
南北韩首脑会谈	南北韩首脑会晤
南北韩高峰会	南北韩首脑会晤
南卡罗莱纳	南卡罗来纳
南大河州	南里奥格兰德州
南奥塞提亚	南奥塞梯
南安礁	海马礁
南屏礁	哈义礁
南康暗沙	巴丁宜阿里浅滩
南海	南中国海
南海礁	曼达纳尼礁
南海礁岛	南中国海礁岛
南海礁岩	南中国海礁岩
南海礁石	南中国海礁石
南海礁群	南中国海礁群
南澳	南澳大利亚
南澳州	南澳大利亚州
南里约格兰州	南里奥格兰德州
博尔基亚	波基亚
占士	詹姆斯
卡加利	卡尔加里
卡加烟	卡加延
卡卡颂	卡尔卡松
卡地夫	加的夫 卡迪夫
卡尔斯鲁尔	卡尔斯鲁厄
卡布里	卡普里
卡托维治	卡托维兹
卡拉卡斯	加拉加斯
卡斯提亚	卡斯蒂利亚
卡斯翠	卡斯特里
卡斯鲁厄	卡尔斯鲁厄
卡林西亚	克恩顿
卡林西亚邦	克恩顿州
卡瑟尔	卡塞尔
卡米尔海	卡梅尔海
卡素加	卡斯尔加
卡纳封	卡纳温
卡纳维尔角	卡纳维拉尔角
卡纳芬	卡纳温 卡那封
卡路什	卡卢什
卡达	卡塔尔
卡迪夫	加的夫
卡迪斯	加的斯
卡那封	卡纳温
卡那封温	卡纳温
卡马斯	卡默斯
卢安达	卢旺达
卢昂	鲁昂
卢比安纳	卢布尔雅那
印威内斯	因弗内斯
印度教	兴都教
危地马拉市	危地马拉城
厄利垂亚	厄立特里亚
厄顿	阿克顿
古拉索	库拉索
古斯塔维亚	居斯塔维亚
可伦坡	哥伦坡
台夫特	代尔夫特
史丹佛	斯塔福德
史丹福	斯坦福
史乐	什罗普
史云斯	斯旺西
史云顿	斯温登
史卓咸	斯特里汉姆
史塔克顿	斯托克顿
史密斯菲	史密斯菲尔德
史托蒙特	斯托蒙特
史提芬纳治	斯蒂夫尼奇
史普利特	斯普利特
史普雷	施普雷
史泰克方丹	斯泰克方丹
史泰利亚	施蒂里亚
史泰利亚邦	施蒂里亚州
史泰尔马克	施泰尔马克
史泰尔马克邦	施泰尔马克州
史泰格利兹	施泰格利茨
史特加	斯图加特
史特拉斯堡	斯特拉斯堡
史特拉福	斯特拉特福
史特拉颂	施特拉尔松德
史特灵	斯特灵
史瓦帝尼	斯威士兰
史笃城	斯托克城
史考兹谷	斯科茨谷
史葛斯谷	斯科茨谷
史蒂文纳吉	斯蒂夫尼奇
史高比耶	斯科普里
叶士域治	伊普斯维奇
叶海亚	耶也 耶哈也
叶海亚	雅也 雅耶
叶里温	埃里温
叶门	也门
司徒加特	斯图加特
吉佳利	基加利
吉尔吉斯	吉尔吉斯斯坦
吉布地	吉布提
吉里巴斯	基里巴斯
吐瓦鲁	图瓦卢
吐芬奴	托菲诺
吕北克	吕贝克
吕北克汉萨自由市	吕贝克汉萨自由市
告罗士打	格洛斯特
和域	沃里克
和夫咸顿	伍尔弗汉普顿
咸美顿	哈密尔顿 汉密尔顿
咸顿	汉普顿
咸默史密夫	哈默史密斯
哈修塔特	哈尔施塔特
哈兹	哈尔茨
哈兹山	哈茨山
哈利姆	哈林
哈利法斯	哈利法克斯
哈勒	哈雷
哈勒贝克	哈勒尔贝克
哈吉	哈芝
哈姆雷特塔	陶尔哈姆莱茨
哈密德	哈密
哈德斯菲	哈德斯菲尔德
哈德逊	哈德森
哈桑	哈山
哈桑纳尔	哈山纳
哈梅恩	哈默尔恩
哈洛	哈罗
哈特斯菲	哈德斯菲尔德
哈特福	哈特福德 赫特福德
哈米德	哈密
哈米迪	哈密迪
哈萨克	哈萨克斯坦
哈非尔河	哈弗尔河
哥利兹	格尔利茨
哥多华	科尔多瓦
哥德人	哥特人
哥德字母	哥特字母
哥德式	哥特式
哥德语	哥特语
哥德风	哥特风
哥打列治	戈德里奇
哥斯大黎加	哥斯达黎加
哥本尼克	克珀尼克
哥特堡	哥德堡
哲林根	策林根
唐卡士打	唐卡斯特
唐桥井	坦布里奇韦尔斯
喀拉哈里沙漠	卡拉哈里沙漠
喀斯开	喀斯喀特
喜士定	黑斯廷斯
嘉兰士	克拉伦斯
嘉兰士柏	克拉伦斯公园
嘉弘	卡文
嘉拿多	科罗纳多
嘉林边	格兰扁
嘉柏隆里	哈博罗内
嘉立咸	克拉珀姆
嘉芙莲	凯瑟琳
因努伊特	因纽特
因戈施塔特	英戈尔施塔特
图林根邦	图林根州
图翁巴	图文巴
土亚莫土	土阿莫土
土克	特克斯
土克凯可	特克斯和凯科斯
土克凯可群岛	特克斯和凯科斯群岛
土奈	图尔奈
土尔沙	塔尔萨
土库曼	土库曼斯坦
土桑	图森
土鲁斯	图卢兹
圣伊天	圣艾蒂安
圣伯纳迪诺	圣贝纳迪诺
圣佑达修斯	圣尤斯特歇斯
圣体市	科珀斯克里斯蒂
圣何塞	圣荷西
圣何西	圣何塞 圣荷西
圣克里斯多福及尼维斯	圣基茨和尼维斯
圣占士	圣詹姆斯
圣地亚哥	圣迭戈
圣地牙哥	圣地亚哥 圣迭戈
圣塔克拉拉	圣克拉拉
圣塔菲	圣菲
圣多明哥	圣多明各
圣多美普林西比	圣多美和普林西比
圣巴瑟米	圣巴泰勒米
圣帕尔滕	圣珀尔滕
圣帕布罗	圣巴勃罗
圣彼得	圣彼得斯
圣德田	圣艾蒂安
圣文森及格瑞那丁	圣文森特和格林纳丁斯
圣楚登	圣特赖登
圣波尔坦	圣珀尔滕
圣海伦娜	圣赫勒拿
圣海莲娜	圣赫勒拿
圣班纳甸奴	圣贝纳迪诺
圣皮耶	圣皮埃尔
圣皮耶与密克隆	圣皮埃尔和密克隆
圣罗伦斯	圣劳伦斯
圣罗沙	圣罗莎
圣老楞佐	圣劳伦斯
圣荷西	圣何塞
圣詹姆士	圣詹姆斯
圣路易斯	圣路易
圣达菲	圣菲
圣非	圣菲
圣马刁	圣马特奥
圣马利诺	圣马力诺
圭内斯	格温内斯
坎埃克吕斯	戛纳埃克吕斯
坎城	康城
坎培拉	堪培拉
坎特伯里	坎特伯雷
坎贝尔河	坎贝尔里弗
坎达哈	坎大哈
坚伯威	坎伯韦尔
坦尚尼亚	坦桑尼亚
坦布里治威尔斯	坦布里奇韦尔斯
坦干伊加	坦噶尼喀
坦米尔	泰米尔 淡米尔
埃及阿拉伯共和国	阿拉伯埃及共和国
埃因霍温	艾恩德霍芬
埃朗根	埃尔朗根
域斯咸	雷克瑟姆
域治	维奇
域菲	韦克菲尔德
域菲路	韦克菲尔德
培亚	普拉亚
基尔福	吉尔福德
基度山	基督山
基替	基耶蒂
基洛夫格勒	基洛沃格勒
基秦拿	基奇纳
基罗纳	赫罗纳
基隆拿	基洛纳
塔吉克	塔吉克斯坦
塔希提	大溪地
塔拉赫西	塔拉哈西
塔斯曼尼亚	塔斯马尼亚
塔斯曼尼亚州	塔斯马尼亚州
塔村	陶尔哈姆莱茨
塞凡堡	塞瓦斯托波尔
塞尔寇克	塞尔扣克
塞尔维亚与蒙特内哥罗	塞尔维亚和黑山
塞席尔	塞舌尔
塞拉耶佛	萨拉热窝
塞维亚	塞维利亚
塞蒙	塞黑
墨巴本	姆巴巴纳
士他令	斯特灵
士多蒙	斯托蒙特
士德顿	斯托克顿
士瓦本	施瓦本
士科德	斯库台
士美菲	史密斯菲尔德
士鲁斯柏立	什鲁斯伯里
处女	维尔京
处女群岛	维尔京群岛
夏力	哈莱克
夏勒华	沙勒罗瓦
夏安	夏延
夏托鲁	沙托鲁
夏洛特敦	夏洛特顿
夏洛腾堡	夏洛滕堡
夏湾拿	哈瓦那
夏灵基	哈林盖
夕利	锡利
外西凡阿尔卑斯山	南喀尔巴阡山脉
多伦士	托伦斯
多佛	多佛尔
多实	多塞特
多明尼加	多米尼加
多罗米提	多洛米蒂
多臣隙	道森克里克
多蒙特	多特蒙德
大不列颠暨北爱尔兰联合王国	大不列颠及北爱尔兰联合王国
大不列颠暨爱尔兰联合王国	大不列颠及爱尔兰联合王国
大本钟	大笨钟
大溪地	塔希提
大英国协	共和联邦
大陆架	大陆棚
夫利佛兰	弗莱福兰
夫罗勒	发罗拉
奇彻斯特	奇切斯特
奇西克	奇司威克
奈及利亚	尼日利亚
奈比多	内比都
奈洛比	内罗毕
契朋罕	奇彭纳姆
奥丹	奥尔德姆
奥云	欧文
奥云湾	欧文桑德
奥克拉荷马	俄克拉荷马
奥克拉荷马城	俄克拉荷马城
奥克拉荷马市	俄克拉荷马城
奥勒冈	俄勒冈
奥卡拿根	奥肯拿根
奥古斯堡	奥格斯堡
奥咸	奥尔德姆
奥塞提亚	奥塞梯
奥巴尼	奥尔巴尼
奥弗佩特	奥弗佩尔特
奥恩·加法尔	翁惹化
奥文尼	奥弗涅
奥斐顿	奥尔弗里顿
奥斯丁	奥斯汀
奥斯滕德	奥斯坦德
奥斯特里兹	奥斯特利茨
奥斯特里茨	奥斯特利茨
奥斯纳布克	奥斯纳布吕克
奥斯纳贝克	奥斯纳布吕克
奥比斯保	奥比斯波
奥沙华	奥沙瓦
奥波列	奥波莱
奥玛	奥马
奥玛鲁	奥马鲁
奥班吉	欧邦日
奥登堡	奥尔登堡
奥迪沙	敖德萨
奥马尔	奥马
姆巴巴内	姆巴巴纳
始路	特雷尔
威克菲	韦克菲尔德
威兹拉尔	韦茨拉尔
威埠	韦维尔
威士拿	惠斯勒
威尔堡	魏尔堡
威尔斯	威尔士
威廉城	威廉斯塔德
威斯康辛	威斯康星
威斯敏斯特	西敏
威斯敏斯特体系	西敏制
威斯敏斯特修道院	西敏寺
威斯敏斯特圣彼得牧师团教堂	西敏市圣彼得牧师团教堂
威斯敏斯特宫	西敏宫
威斯敏斯特教堂	西敏寺
威明顿	威尔明顿
威治	维奇
威灵顿	惠灵顿
威玛	魏玛
威瑟尔	韦瑟尔
威登堡	维滕贝格
威登拉特	韦尔登拉特
威维克	韦尔菲克
宁静湖	普莱西德湖
安克拉治	安克雷奇
安利柏	安利公园
安古兰	昂古莱姆
安吉拉	安圭拉
安哈拉	阿姆哈拉
安地列斯	安的列斯
安地卡及巴布达	安提瓜和巴布达
安地斯	安第斯
安域	阿因维克
安塔那那利佛	塔那那利佛
安德列治	安德莱赫特
安提阿克	安条克
安提顿	安蒂特姆
安瓦尔	安华
安登	昂代讷
安纳海姆	阿纳海姆
安达鲁西亚	安达卢西亚
安那翰	阿纳海姆
安锡	阿讷西
宏都拉斯	洪都拉斯
宣德班	孙德尔本斯
宾兹	宾茨
宾士域	不伦瑞克
宾夕凡尼亚	宾夕法尼亚
宾顿	布兰普顿
宿雾	宿务
密尔瓦基	密尔沃基
密德兰	米德兰
密德瑟斯	米德尔塞克斯
密芝根	密歇根
密西根	密歇根
富咸	富勒姆
富图那	富图纳
富来顿	富勒顿
对朝政策	对北政策
对衡	达勒姆
小岩城	小石城
尚佩恩	香槟
尚吉巴	桑给巴尔
尚布赖莱都尔	尚布赖莱图尔
尚比亚	赞比亚
尤比亚	埃维亚
尼加拉	尼亚加拉
尼尔斯普鲁特	内尔斯普雷特
尼德宁	纳蒂灵
尼披盛	尼皮辛
尼日	尼日尔
尼柯西亚	尼科西亚
尼科平	尼雪平
尼维尔	讷韦尔
尼美根	奈梅亨
尼阿美	尼亚美
屈福特	沃特福德
屋仑	奥克兰
屋威老	奥克维尔
山景城	芒廷维尤
山静咸	桑德灵厄姆
岩哈拉	阿姆哈拉
峇里	峇厘
川斯凯	特兰斯凯
川斯瓦	德兰士瓦
己连加利	格伦加里
己连围	格伦维尔
己连拿奴	格莱内尔格
己连柯士文	格伦奥斯蒙德
巴伐利亚邦	巴伐利亚州
巴休敦	巴西尔登
巴佛士	巴瑟斯特
巴兆敦	巴西尔登
巴内特	巴尼特
巴利亚利	巴利阿里
巴利亚利群岛	巴利阿里群岛
巴勒摩	巴勒莫
巴卡	峇卡
巴卡尔	峇卡
巴厘	峇厘
巴域	伯立克
巴塞隆拿	巴塞罗那
巴塞隆纳	巴塞罗那
巴士地	巴斯特尔
巴富	珀斯
巴布亚新畿内亚	巴布亚新几内亚
巴布亚纽几内亚	巴布亚新几内亚
巴布烟	巴布延
巴拉福特	布拉德福德
巴拉马利波	帕拉马里博
巴摩卢	巴尔莫勒尔
巴摩拉	巴尔莫勒尔
巴斯提亚	巴斯蒂亚
巴斯通	巴斯托涅
巴林坦	巴林塘
巴比提	帕皮提
巴特溪	巴特尔克里克
巴符邦	巴符州
巴纽	巴新
巴美拉	巴尔米拉
巴芙	巴斯
巴萨尔	博瑟尔
巴贝多	巴巴多斯
巴赫姆特	巴赫穆特
巴达维	巴达威
巴顿鲁治	巴吞鲁日
巽德兰	桑德兰
巽德班	孙德尔本斯
布亨瓦德	布痕瓦尔德
布伦亨	布伦海姆
布伦来	布罗姆利
布兰岱	布兰太尔
布兰登堡	勃兰登堡
布兰登堡邦	勃兰登堡州
布力希斯	布莱克希斯
布力般	布莱克本
布吉纳法索	布基纳法索
布哥斯	布尔戈斯
布拉克本	布莱克本
布拉干	布拉卡
布拉提斯拉瓦	布拉迪斯拉发
布拉福	布拉德福德
布拉萨	布拉柴
布拉萨市	布拉柴维尔
布拉邦	布拉班特
布松布拉	布琼布拉
布林斯贝利	布卢姆茨伯里
布林格兰	布灵厄兰
布查	布恰
布根兰	布尔根兰
布根兰邦	布尔根兰州
布洛瓦利	布罗瓦里
布灵顿	伯灵顿
布莱斯河谷	布莱斯瓦利
布莱梅	不莱梅
布莱梅港	不来梅哈芬
布莱梅邦	不莱梅州
布莱顿	布赖顿
布蓝兹维	不伦瑞克
布里斯托	布里斯托尔
布里斯托路	布里斯托尔路
布里斯本	布里斯班
布隆泉	布隆方丹
布雷恩垂	布伦特里
布雷根兹	布雷根茨
布鲁姆斯伯里	布卢姆茨伯里
希斯凯	西斯凯
希斯洛	希思罗
希斯路	希思罗
希格堡	锡格堡
希梅	希迈
希沙慕丁	希山慕丁
帕勒莫	巴勒莫
帕拉纳	帕瑞纳
帕迈拉	巴尔米拉
帕里克尔	帕利基尔
帛琉	帕劳
席凡宁根	斯海弗宁恩
席根	锡根
席瑞丝	锡里斯
席车士打	奇切斯特
干河	德赖河
干诺	康乐 康诺特
干贡	甘冈
广萨	宽扎
庇里牛斯	比利牛斯
库夫斯坦	库夫施泰因
库德	库尔德
库赛埃	科斯雷
康乃狄克	康涅狄格
康伯威尔	坎伯韦尔
康兹	孔茨
康和	康沃尔
康埃克吕斯	戛纳埃克吕斯
康城	卡昂
康培拉	坎帕拉
康士坦兹	康斯坦茨
康山	康希尔
康比涅	贡比涅
康瓦尔	康沃尔
康瓦耳	康沃尔
康登	卡姆登
康西暗沙	莫迪礁
康诺特	康乐
延德纳岛	扬德纳岛
延文礼士	因弗内斯
开云	卡宴
弗威耶	韦尔维耶
弗次瓦夫	弗罗茨瓦夫
弗莱堡	弗赖堡
弹丸礁	拉央拉央岛
强斯顿	约翰斯顿
强斯顿岛	约翰斯顿岛
强斯顿环礁	约翰斯顿环礁
弼	比特
归融语	克里奥尔语
彼得堡	彼得伯勒
彼得波罗	彼得伯勒
彼德堡	彼得伯勒
律伦	拉特兰
德云	德文
德克萨斯	得克萨斯
德凯利亚	亚克罗提利
德勒斯登	德累斯顿
德古西加巴	特古西加尔巴
德基利亚	亚克罗提利
德尔班	德班
德州	得州
德拉瓦州	特拉华州
德梅因	得梅因
德罕	达勒姆
德芙灵	达弗林
德萨斯	得克萨斯
必列者窝打	布里奇沃特
必嘉岛	贝克岛
必嘉街	贝克街
忘忧宫	无忧宫
快富	法夫
怀特霍斯	白马市
怡朗	伊洛伊洛
恩加美纳	恩贾梅纳
恩荷芬	艾恩德霍芬
恩菲	恩菲尔德
恩菲特	恩菲尔德
惹化	嘉法 惹法 查化
慕森加柏	门兴格拉德巴赫
慕礼	莫里
慕豪森	米尔豪森
慕逊加柏	门兴格拉德巴赫
戎布鲁	让布卢
戛纳	康城
戴尔豪斯	达尔豪斯
扎因丁	再努丁
打比	德比
托列斯	托雷斯
托利斯	托雷斯
托彼卡	托皮卡
托斯卡尼	托斯卡纳
托雷多	托莱多
扶莲	弗林特
拉吉欧	拉齐奥
拉哥斯	拉各斯
拉夫伯勒	拉夫堡
拉希德	拉昔
拉惹加隆浅滩	艾肯礁
拉扎克	拉萨
拉曼查	拉曼恰
拉法叶	拉斐特
拉素	拉齐奥
拉维洛	拉韦洛
拉萨克	拉萨
拉赫曼	拉曼
拔林敦	普林普顿
拔林敦柏	普林普顿帕克
拜仁邦	拜仁州
拜律特	拜罗伊特
拜恩邦	拜恩州
拜洛特	拜罗伊特
拿坡里	拿波利 那不勒斯
拿索	拿骚
措必列治	特罗布里奇
提林斯	梯林斯
提比里斯	第比利斯
提洛	蒂罗尔
提洛邦	蒂罗尔州
提顿	蒂顿
摩保利	莫德伯里
摩加迪休	摩加迪沙
摩斯比	莫尔斯比
摩斯比港	莫尔斯比港
摩策尔	莫策尔
摩鹿加	马鲁古
敖得萨	敖德萨
敦克尔克	敦刻尔克
敦巴顿	邓巴顿
数位及交通部	数字化和交通部
数码及交通部	数字化和交通部
文莱	汶莱
文莱达鲁萨兰国	汶莱达鲁萨兰国
文西德	文西德尔
斯华坦尼奥	锡瓦塔内霍
斯塔弗洛	斯塔沃洛
斯塞新	什切青
斯泰尔	施泰尔
斯洛维尼亚	斯洛文尼亚
斯派尔	施派尔
斯温顿	斯温登
斯潘达勒姆	施庞达勒姆
斯潘道	施潘道
斯特里萨姆	斯特里汉姆
斯特雷特姆	斯特里汉姆
斯里巴卡旺	斯里巴加湾
新不伦瑞克	新布兰斯威
新佐治亚	新乔治亚
新南威尔士	新南威尔斯
新南威尔士州	新南威尔斯州
新堡	纽卡斯尔
新布蓝兹维	新不伦瑞克 新布兰斯威
新帕札	新帕扎尔
新斯科细亚	新斯科舍 诺瓦斯科舍
新斯科舍	诺瓦斯科舍
新沙德	诺维萨德
新港	波多诺伏 纽波特
新特兰	桑德兰
新畿内亚	新几内亚
新罕布夏	新罕布什尔
新莫斯科斯克	新莫斯科夫斯克
新西兰	纽西兰
新西敏	新威斯敏斯特
施他佛	斯塔福德
施威林	什未林
施普利特	斯普利特
施洛普	什罗普
施蒂利亚	施蒂里亚
施蒂利亚州	施蒂里亚州
日内普	热纳普
日耳曼邦联	德意志邦联
旺兹沃斯	旺兹沃思
旺阿芝莎	旺阿兹莎
昆士柏	女王公园
明尼亚波利斯	明尼阿波利斯
易卜拉欣	依布拉欣
昔得兰	设德兰
昔德兰	设德兰
春田市	斯普林菲尔德
晓伦	休伦
普利茅夫	普利茅斯
普勒托利亚	比勒陀利亚
普勒陀尼亚	比勒陀利亚
普法兹	普法尔茨
普法茨	普法尔茨
普里斯提纳	普里什蒂纳
普雷史考特	普雷斯科特
景隆	坎农
智利域	奇利瓦克
暗士党	阿姆斯特朗
曼克顿	曼哈顿
曼图亚	曼托瓦
曼尼托巴	曼尼多巴
曼岛	马恩岛
曼提加	曼特卡
曼斯菲尔	曼斯菲尔德
曼斯菲特	曼斯菲尔德
曼非斯	孟菲斯
曾母暗沙	詹姆士暗沙
朋札	奔萨
朝方	北韩方面
朝韩	南北韩
朝韩首脑会晤	南北韩首脑会晤
朝鲜	北韩
朝鲜与韩国	北韩与南韩
朝鲜以及韩国	北韩以及南韩
朝鲜及韩国	北韩及南韩
朝鲜同韩国	北韩同南韩
朝鲜和韩国	北韩和南韩
朝鲜战争	韩战
朝鲜独立运动	韩国独立运动
札格瑞布	萨格勒布
札法尔	嘉法 惹化
札法尔	惹法 查化
札波罗热	扎波罗热
朴茨茅夫	朴次茅斯
朴茨茅斯	朴次茅斯
李斯特	莱斯特
李治菲特	利奇菲尔德
杜哈	多哈
杜塞道夫	杜塞尔多夫
杜尚贝	杜尚别
杜斯多夫	杜塞尔多夫
杜林	都灵
杜根咸	达格纳姆
杜笃玛	多多马
杰佛逊城	杰斐逊城
杰克孙维	杰森维尔
杰克森	杰森
杰克逊	杰森
杰克逊维尔	杰森维尔
林兹	林茨
林吉特	令吉
林雪坪	林雪平
林雪平	林雪坪
柏世	帕克赛德
柏京	巴金
柏克莱	伯克利
柏卫	贝尔维尤
柏嘉	波基亚
柏本克	伯班克
柏林邦	柏林州
柏灵顿	帕丁顿
柏纳比	本拿比
柠檬林	莱蒙格罗韦
查令	查灵
查哥斯	查戈斯
查德	乍得
查洛顿	夏洛特顿
柯士甸	奥斯汀
柯罗	科罗尔
柯蒂纳戴比索	科尔蒂纳丹佩佐
柯那克里	科纳克里
根德	肯特
格兰坪	格兰扁
格列士敦	格拉德斯通
格域	盖特威克
格士黑德	盖茨黑德
格拉兹	格拉茨
格拉拿达	格拉纳达
格来斯瓦德	格赖夫斯瓦尔德
格林威治	格林尼治
格洛索普	格洛瑟普
格瑞那达	格林纳达
格罗索普	格洛瑟普
桑德令罕	桑德灵厄姆
桑治奥	松德里奥
桥港	布里奇波特
桥镇	布里奇顿
梅加瓦蒂	美加华蒂
梅嘉娃蒂	美加华蒂
梅铎	莫道克
梳利侯	索利赫尔
梳士巴利	索尔兹伯里
梳士贝利	什鲁斯伯里
棉登	明登
森吉列伊	先吉列伊
森林地	伍德兰
森麻实	索美塞
楚胡伊夫	丘胡伊夫
榆亚暗沙	柏宁礁
模里西斯	毛里求斯
欢乐暗沙	美巴蒂滩
欧伊朋	奥伊彭
欧文湾	欧文桑德
欧登堡	奥尔登堡
歌来顿	克罗伊登
比亚希兹	比亚里茨
比勒菲尔德	比勒费尔德
比斯凯克	比什凯克
比更士菲	比肯斯菲尔德
比立勤	布拉卡
比路贺利桑特	贝洛奥里藏特
毕尔包	毕尔巴鄂
毛布朗	毛尔布龙
毛里裘斯	毛里求斯
民答那峨	棉兰老
民答那峨岛	棉兰老岛
水牛城	布法罗
汉弥尔顿	哈密尔顿
汉斯	兰斯
汉米顿	汉密尔顿
汉默史密斯	哈默史密斯
汤玛士	托马斯
汶莱	文莱
汶莱和平之国	文莱达鲁萨兰国 汶莱达鲁萨兰国
汶莱达鲁萨兰国	文莱达鲁萨兰国
沃克斯霍尔	沃克斯豪尔
沃加沃加	瓦加瓦加
沃姆斯	沃尔姆斯
沃尔夫斯伯格	沃尔夫斯贝格
沃尔珊斯托	沃尔瑟姆斯托
沃特顿	活特顿
沃索尔	沃尔索尔
沙乌地	沙地
沙乌地阿拉伯	沙地阿拉伯
沙加缅度	萨克拉门托
沙尼亚	萨尼亚
沙尼治	萨尼奇
沙必里	沙比里
沙拉哥萨	萨拉戈萨
沙斯加通	萨斯卡通
沙斯卡寸旺	萨斯卡渣文 萨斯喀彻温
沙比利	沙比里
沙特	沙地
沙特阿拉伯	沙地阿拉伯
沙福	萨福克
沙那	萨那
沙问暗	萨蒙阿姆
沙马德	沙末
泄兰	设德兰
法兰克尼亚地区	弗兰肯地区
法兰克尼亚行政区	弗兰肯行政区
法兰德斯	佛兰德
法兰科夫斯克	弗兰科夫斯克
法哥	法戈
法尔兹	普法尔茨
法属玻里尼西亚	法属波利尼西亚
法恩堡	法恩伯勒
法显暗沙	琳吉礁
法梅恩	法梅讷
波伦亚	博洛尼亚
波佩林厄	波珀灵厄
波兹坦	波茨坦
波塔瓦	波尔塔瓦
波士尼亚与赫塞哥维纳	波斯尼亚和黑塞哥维那
波士尼亚克	波什尼亚克
波夕	博伊西
波奈	博奈尔
波尔察诺	博尔扎诺
波尔顿	博尔顿
波布那	博普塔茨瓦纳
波德里查	波德戈里察
波斯尼亚	波士尼亚
波昂	波恩
波朗	博兰
波札那	博茨瓦纳
波格伦	博尔赫隆
波登湖	博登湖
波美恩	波美拉尼亚
波茵	波英
波莫瑞	波美拉尼亚
波赫	波黑
波里斯皮尔	鲍里斯皮尔
波隆纳	博洛尼亚
泰恩	泰因
泰益·马哈茂德	泰益玛目
泰米尔	淡米尔
泽凯利亚	亚克罗提利
洛戴	洛迪
洛蒙	洛蒙德
洛达咸	罗瑟勒姆
活士	伍兹
活橡	利夫奥克
派丁顿	帕丁顿
海克力斯	赫拉克勒斯
海参崴	符拉迪沃斯托克
海宁礁	沙吉礁
海安礁	沙合礁
海尔斯罕	黑尔舍姆
海布隆	海尔布隆
海康暗沙	阿顺礁
海机治	海格特
淡米尔	泰米尔
深圳湾	后海湾
温切斯特	温彻斯特
温尼辟	温尼伯
温布利亚	翁布里亚
温布莱	温布利
温布顿	温布尔登
温特窝夫	温特沃斯
温荷克	温得和克
温车士打	温彻斯特
温达	文达
渭州	威尔特
湾斯禾夫	旺兹沃思
满地可	蒙特利尔
滨世	伯恩赛德
漆咸	查塔姆
潭门礁	万年烟礁
澄平礁	白石滩
澳大利亚	澳洲
澳洲	澳大利亚
澳洲联邦	澳大利亚联邦
火奴鲁鲁	檀香山
焦尔	杰尔
燕豪芬	艾恩德霍芬
爱丽斯泉	艾丽斯斯普林斯
爱兰立	厄于拉讷
爱华勒	埃弗拉德
爱华勒柏	埃弗拉德帕克
爱塞	艾瑟尔
爱尔朗根	埃尔朗根
爱尔福特	埃尔福特
爱德华城	爱德华兹敦
爱德蒙顿	埃德蒙顿
爱民顿	埃德蒙顿
爱特咸	埃尔特姆
爱第尼	埃迪尔内
爱荷华	艾奥瓦
爱蒙顿	埃德蒙顿
特伦提诺	特伦蒂诺
特伦特河畔史笃	特伦特河畔斯托克
特伦甘纳	泰伦加纳
特华	特鲁瓦
特普利策	特普利采
特诺皮尔	捷尔诺波尔
特雷斯登	德累斯顿
特鲁华	特鲁瓦
犹加敦	尤卡坦
狄力	帝力
狄蒙	得梅因
独立国协	独联体
狮子山	塞拉利昂
狼堡	沃尔夫斯堡
玻里尼西亚	波利尼西亚
班列特	巴尼特
班基	班吉
班布里治	班布里奇
班来	伯恩利
班竹	班珠尔
班迪哥	本迪戈
琉森	卢塞恩
琳宝	兰贝斯
琼台礁	文丁破礁
瑟比利	萨德伯里
瓜加林	夸贾林
瓜地洛普	瓜德罗普
瓜地马拉	危地马拉
瓜地马拉市	危地马拉城
瓜达康纳尔	瓜达尔卡纳尔
瓦兹曼	瓦茨曼
瓦内顿	瓦尔讷通
瓦勒他	瓦莱塔
瓦哈	华合
瓦哈比	华合
瓦尔斯	法尔斯
瓦尔珊森林	沃尔瑟姆福里斯特
瓦拉多利德	巴利亚多利德
瓦特福	沃特福德
瓦特顿	活特顿
瓦都兹	瓦杜兹
甘比亚	冈比亚
甘比尔山	芒特甘比尔
甘露	坎卢普斯
甘马仁	甘马粦
申根公约	申根协议
留尼旺	留尼汪
畿内亚	几内亚
畿内亚比绍	几内亚比绍
登地	邓迪
登巴	邓巴
登打士	邓达斯
白令根	贝灵恩
白兰轩	布伦海姆 布林德海姆
白加	巴克
白加山	芒特巴克
白朗峰	勃朗峰
白礼顿	布赖顿
百慕达	百慕大
百福	贝德福德
皆因	卡宴
皇后大学	女王大学
皮利士葛	普雷斯科特
皮特肯	皮特凯恩
盖兹赫德	盖茨黑德
盖威克	盖特威克
盟谊暗沙	友谊礁
真尼沙	开姆尼茨
矽谷	硅谷
砵兰	波特兰
碧勤翠	贝肯翠
社本	舍伯恩
祖格峰	楚格峰
神根	申根
神根公约	申根协议
福尔特	菲尔特
福恩	弗尔讷
福拉尔贝格邦	福拉尔贝格州
禧福	赫里福德
禾京顿	沃金顿
禾夫斯堡	沃尔夫斯堡
禾获甸拿	伏伊伏丁那
科伦坡	哥伦坡
科发	福弗尔
科多瓦牧场	兰乔科尔多瓦
科布伦兹	科布伦茨
科敏	科米讷
科特迪瓦	象牙海岸
科特里克	科特赖克
科罗拉多泉	科罗拉多斯普林斯
科芬特里	考文垂
科赤	科尔察
科赤斯特	科尔切斯特
积逊	杰森
积逊威尔	杰森维尔
穆希丁	慕尤丁
穆斯佐	穆斯乔
穆斯塔法	慕斯达法
穆罕默德	莫哈末
突尼斯	突尼西亚
突尼西亚	突尼斯
窝咸史杜	沃尔瑟姆斯托
窝咸森林	沃尔瑟姆福里斯特
窝士打	伍斯特
窝打老	滑铁卢
立斯摩尔	利斯莫尔
端古·赛义德·西拉杰丁	端姑赛西拉祖丁
端姑赛义德·西拉杰丁	端姑赛西拉祖丁
端姑赛西拉如丁	端姑赛西拉祖丁
符兹堡	维尔茨堡
第尼伯	第聂伯罗
第尼伯彼得罗夫斯克	第聂伯罗彼得罗夫斯克
第巴尔	迪勃拉
第开特	迪凯特
策提涅	采蒂涅
簸箕礁	西布礁
米占·再纳·阿比丁	米占再纳阿比丁
米尔布雷	密尔布瑞
米尔果罗德	米尔哥罗德
米德尔斯堡	米德尔斯伯勒
米德斯堡	米德尔斯伯勒
米杜士堡	米德尔斯伯勒
米詹	米占
米詹·扎因·阿比丁	米占再纳阿比丁
索兹伯里	索尔兹伯里
索维托	索韦托
索美塞特	索美塞
索顿	萨顿
索马利亚	索马里
索马利兰	索马里兰
红木城	雷德伍德城
红桥	雷德布里奇
约纳河	约讷河
约纳省	约讷省
约翰尼斯堡	约翰内斯堡
约郡	约克郡
纳华拉	纳瓦拉
纳卯市	达沃市
纳吉布	纳吉
纳哈扬	纳言
纳士维	纳什维尔
纳戈尔诺卡拉巴赫	纳戈尔诺
纳木尔	那慕尔
纳次福	纳茨福德
纳潘尼	纳帕尼
纳米比亚	那米比亚
纳许维尔	纳什维尔
纽华克	纽瓦克
纽卡素	纽卡斯尔
纽卡索	纽卡斯尔
纽咸	纽汉
纽堡	尼尔堡
纽奥良	新奥尔良
纽宾士域	新不伦瑞克 新布兰斯威
纽沙特	纳沙泰尔 讷沙托 讷沙泰勒
纽泽西	新泽西
纽英伦	新英格兰
纽马赫	诺伊马克特
经济事务和气候行动部	经济和气候保护部
经济合作及发展部	经济合作与发展部
维也纳邦	维也纳州
维京	维尔京
维京群岛	维尔京群岛
维冈	威根
维吉尼亚	弗吉尼亚
维希	维琪
维德角	佛得角
维根	威根
维特沃斯	惠特沃斯
维特祖治	惠特彻奇
维珍尼亚	弗吉尼亚
维瓦特斯兰	威特沃特斯兰德
维萨亚人	米沙鄢人
维萨亚斯	米沙鄢
绿德斯翰	吕德斯海姆
绿根	吕根
绿根岛	吕根岛
绿湾	格林贝
缅尼吐巴	曼尼多巴
缅尼图连	马尼图林
缅尼托巴	曼尼托巴
缅恩斯	美因茨
罗亚尔河	卢瓦尔河
罗亚罗克桑斯	卢瓦罗克桑斯
罗德岛	罗得岛
罗德西亚	罗得西亚
罗慈地	罗奇代尔
罗拉赫	勒拉赫
罗梭	罗索
罗素	拉塞尔
罗里	罗利
美利	墨累
美善同	梅德斯通
美因兹	美因茨
美度息士	米德尔塞克斯
美度石士	米德尔塞克斯
美景市	贝洛奥里藏特
美熹德	默塞德
美茵	美因
美茵兹	美因茨
美西纳	墨西拿
翠丝	特雷西
翠登	特伦顿
老安道尔	安道尔城
老挝	寮国
老挝人民民主共和国	寮人民民主共和国
老挝文	寮文
老挝法国保护国	寮法国保护国
老挝王国	寮王国
老挝语	寮语
考那斯	考纳斯
耶洛奈夫	黄刀镇
聂伯	第聂伯
聂伯城	第聂伯罗 第聂伯罗彼得罗夫斯克
聂斯特	德涅斯特
联福	伦弗鲁
联邦资料处理标准	联邦信息处理标准
肯亚	肯尼亚
肯尼兹	开姆尼茨
肯诺拉	凯诺拉
胡列治	伍利奇
胡格斯特拉顿	霍赫斯特拉滕
腓特烈顿	弗雷德里克顿
舒兹伯利	什鲁斯伯里
舒梨	萨里
舒维兹	施维茨
般尼	伯恩利
般尼茅夫	伯恩茅斯
艾丁	埃尔丁
艾伯特	阿尔伯特
艾克利内	埃尔克利讷
艾卜耶	阿卜耶伊
艾厄士米尔	埃尔斯米尔
艾哈迈德	阿末
艾塞克斯	埃塞克斯
艾夫拉塔	埃夫拉塔
艾希特	埃克塞特
艾斯科	埃斯科
艾斯美	埃尔斯米尔
艾森纳赫	爱森纳赫
艾比尔	埃尔比勒
艾比路	阿比路
艾特瓦特	阿特沃特
艾珊	埃尔特姆
艾福特	埃尔福特
芝华塔尼欧	锡瓦塔内霍
芬士巴利	芬斯伯雷
芬斯伯里	芬斯伯雷
芳堤娜	弗隆特纳克
芳登广场	旺多姆广场
苏克瑞	苏克雷
苏加诺	苏卡诺
苏哈托	苏哈多
苏彝士	苏伊士
苏彝士运河	苏伊士运河
苏必略	苏必利尔
苏连多	索伦托
苗顿	米尔顿
英伦海峡	英吉利海峡
英属哥伦比亚	不列颠哥伦比亚 卑诗
英皇佐治广场	乔治王广场
英皇十字	国王十字
英联邦	共和联邦
茂路凡	莫尔文
茅利塔尼亚	毛里塔尼亚
茉莉亚岛	莫雷阿岛
茵斯布鲁克	因斯布鲁克
茶树涌	蒂特里加利
茹埃莱都尔	茹埃莱图尔
荷伯特	霍巴特
荷尼阿拉	霍尼亚拉
荷属安地列斯	荷属安的列斯
荷属沙巴	萨巴
荷巴特	霍巴特
荷甫	霍夫
荷里活	好莱坞
荷顿	哈尔顿
莫三比克	莫桑比克
莫士比	莫尔斯比
莫士比港	莫尔斯比港
莫夕亚	穆尔西亚
莫洛尼	莫罗尼
莫瑟尔	摩泽尔
莫西亚	穆尔西亚
莱因兰	莱茵兰
莱思罗普	拉斯罗普
莱普邦	莱普州
莱法邦	莱法州
莱波萨维奇	莱波萨维齐
莱赫瑙	赖兴瑙 赖谢瑙
获加围	沃克维尔
获素	沃克斯豪尔
菲士兰	弗里斯兰
菲尼克斯	凤凰城
菲德里克	弗雷德里克
菲沙	弗雷泽
菲瑟涅	弗雷西内
萌岛	马恩岛
萨丁尼亚	撒丁
萨伊德	赛益
萨克其万	萨斯喀彻温
萨克森邦	萨克森州
萨安邦	萨安州
萨尔兰邦	萨尔兰州
萨尔布鲁根	萨尔布吕肯
萨尔斯堡	萨尔茨堡
萨尔斯堡州	萨尔茨堡州
萨尔斯堡邦	萨尔茨堡州
萨尔邦	萨尔州
萨拉赫丁	沙拉胡丁
萨斯喀屯	萨斯卡通
萨斯喀彻温	萨斯卡渣文
萨斯奎哈纳	萨斯奎汉纳
萨特河	萨尔特河
萨特省	萨尔特省
萨瑟克	南华克
萨赫尔	萨赫勒
萨雷诺	萨莱诺
萨马德	沙末
萨默塞特	索美塞
落基	洛矶
落矶	洛矶
葛兰盖瑞	格伦加里
葛摩	科摩罗
蒂宾根	图宾根
蒙佩利尔	蒙彼利埃
蒙哲腊	蒙特塞拉特
蒙特佩利尔	蒙彼利埃
蒙特内哥罗	黑山
蒙特娄	蒙特利尔
蒙特瑞	蒙特雷
蒙特维多	蒙得维的亚
蒙皮立	蒙彼利埃
蒲庶庇	普罗斯佩克特
蒲福	博福尔
蒲隆地	布隆迪
蔚蓝海岸	蓝色海岸
薛邓咸	锡德纳姆
衞氏朝鲜	卫氏朝鲜
衞满朝鲜	卫满朝鲜
衡州	汉普
衣索比亚	埃塞俄比亚
西伐利亚	威斯特法伦
西利西亚	西里西亚
西南非	西南非洲
西发利亚	威斯特法伦
西哥德	西哥特
西恩纳	锡耶纳
西拉如丁	西拉祖丁
西拉杰丁	西拉祖丁
西敏	威斯敏斯特
西敏宫	威斯敏斯特宫
西格马林根	锡格马林根
西法伦	威斯特法伦
西波美拉尼亚	前波美拉尼亚
西滩	韦斯特比奇
西澳州	西澳大利亚州
西米卡绵	西密卡米恩
西维尔	塞维利亚
西罕	西汉姆
西谷	塞尔扣克
詹姆士	詹姆斯
设得兰	设德兰
诗贝亚	施派尔
诺丁罕	诺丁汉
诺克少	努瓦克肖特
诺华斯高沙	新斯科舍 诺瓦斯科舍
诺咸顿	北安普顿
诺域治	诺里奇
诺士佛	纳茨福德
诺威治	诺里奇
诺定咸	诺丁汉
诺尔省	北部省
诺曼第	诺曼底
诺活	诺伍德
诺鲁	瑙鲁
谢尔本	舍伯恩
谢赫·穆扎法尔	赛慕查化
谭沃思	塔姆沃思
谭禾夫	塔姆沃思
象牙海岸	科特迪瓦
豪士罗	豪恩斯洛
贝云	巴约讷
贝南	贝宁
贝司兰	别斯兰
贝夫农绿地	贝夫诺格林
贝尔墨邦	贝尔莫潘
贝尔嫩	贝尔讷姆
贝尔格勒	贝尔格莱德
贝德福	贝德福德
贝思纳尔绿地	贝夫诺格林
贝杰拉克	贝尔热拉克
贝罗那	贝洛纳
贝里斯	伯利兹
贝里琉	佩莱利乌
贝隆纳	贝洛纳
费希特山	菲希特尔山
费特咸	费尔特姆
费里曼图	弗里曼特尔
费雷堡	弗赖堡
贾法	嘉法 惹化
贾法	惹法 查化
赖比瑞亚	利比里亚
赖索托	莱索托
赛义夫	赛夫
赛义德	赛益
赛普勒斯	塞浦路斯
赤斯特街	切斯特勒斯特里特
赤斯特非	切斯特菲尔德
赫内	黑尔讷
赫塞哥维纳	黑塞哥维那
赫尔河畔京斯敦	赫尔河畔金斯敦
赫瑞福	赫特福德 赫里福德
赫福	赫特福德
路易咸	刘易舍姆
路易士港	路易港
路易斯罕	刘易舍姆
路沙卡	卢萨卡
车士打	切斯特
车士打菲特	切斯特菲尔德
车士打郡	柴郡
车尼夫契	切尔诺夫策
车特咸	切尔滕纳姆
车诺比	切尔诺贝利
车路士	切尔西
辛巴威	津巴布韦
辛布	廷布
辛菲洛普	辛菲罗波尔
辛费罗波尔	辛菲罗波尔
达佛	达尔富尔
达卡	达喀尔
达姆城	达姆施塔特
达拉谟	达勒姆
达根罕	达格纳姆
达浩	达豪
达雅克	达雅
迈亚密	迈阿密
迪克斯木德	迪克斯迈德
迪尔道夫	迪尔多夫
迪耶普	第厄普
通托维	汤多威
道森河	道森克里克
邓寇克	敦刻尔克
那不勒斯	拿波利
都兰	图赖讷
都尔	图尔
鄂图曼	奥斯曼
采伦道夫	采伦多夫
里兹	利兹
里奇蒙	里士满
里希坦伯格	利希滕贝格
里朗威	利隆圭
里耳	里尔
金夏沙	金沙萨
金奈	清奈
金宝	坎贝尔
金宝城	坎贝尔敦
金宝河	坎贝尔里弗
金巴伦	坎伯兰 坎布里亚
金石城	金斯敦
钓鱼台	钓鱼岛
钓鱼台列屿	钓鱼岛及其附属岛屿
钓鱼台及其附属岛屿	钓鱼岛及其附属岛屿
钦奈	清奈
锡慕查化	赛慕查化
锡菲	谢菲尔德
锦禄	坎卢普斯
门洛公园	门洛帕克
闪高	锡姆科
阁伦	科克伦
阿亨	亚琛
阿什哈巴特	阿什哈巴德
阿他加马	阿塔卡马
阿伯尼	奥尔巴尼
阿克提卡	奥赫蒂尔卡
阿克罗蒂里	亚克罗提利
阿克罗蒂里和泽凯利亚	亚克罗提利和德凯利亚
阿克鲁帝利	亚克罗提利
阿克鲁帝利及德基利亚	亚克罗提利和德凯利亚
阿卜杜勒	阿都
阿卜杜勒-阿齐兹	阿都阿兹
阿卜杜勒·拉希姆	阿都拉欣
阿卜杜勒·拉扎克	阿都拉萨
阿卜杜勒·拉赫曼	阿都拉曼
阿卜杜勒·阿齐兹	阿都阿兹
阿卜杜勒·马利克	阿都马力
阿卜杜拉	阿都拉
阿卜杜拉·巴达威	阿都拉·巴达威
阿卜杜拉·巴达维	阿都拉·巴达威
阿哥纳	阿尔戈纳
阿姆胡特	艾尔姆胡尔特
阿姆霍特	艾尔姆胡尔特
阿密达	阿米代尔
阿尔卑斯	阿尔派恩
阿尔维	阿威
阿尤布	阿育
阿布·巴卡尔	阿布峇卡
阿布加	阿布贾
阿布奎基	阿尔伯克基
阿布巴卡	阿布峇卡
阿布巴卡尔	阿布峇卡
阿布达比	阿布扎比
阿布都	阿都
阿布都-阿济兹	阿都阿兹
阿布都·阿济兹	阿都阿兹
阿布都拉	阿都拉
阿布都拉·巴达威	阿都拉·巴达威
阿布都拉曼	阿都拉曼
阿庇亚	阿皮亚
阿得雷德	阿德莱德
阿德莱得	阿德莱德
阿必尚	阿比让
阿拉伯联合大公国	阿拉伯联合酋长国
阿拉姆	阿兰
阿拉巴马	亚拉巴马
阿拉米达	阿拉梅达
阿斯玛拉	阿斯马拉
阿梅尔	阿尔梅勒
阿济兹	阿兹
阿特兰大	亚特兰大
阿玛菲	阿马尔菲
阿联	阿联酋
阿芝莎	阿兹莎
阿费尔德	阿尔费尔德
阿迪斯阿贝巴	亚的斯亚贝巴
阿都·拉欣	阿都拉欣
阿都·拉萨	阿都拉萨
阿风索克劳迪欧	阿方索克劳迪乌
阿齐兹	阿兹
阿齐扎	阿兹莎
陶域	特威德
陶菲克	道菲
隆河	罗讷河
隆河新堡	罗讷新堡
隆河省	罗讷省
隐波暗沙	拿督打立礁
隠波暗沙	拿督打立礁
雀西	特雷西
雅各布	耶谷
雅宾利	奥尔巴尼
雅尔达	雅尔塔
雅恩德	雅温得
雅息士	埃塞克斯 艾塞克斯
雅息特	埃克塞特
雅拉伦拉	亚拉伦拉
雅柯布	耶谷
雅穆索戈	亚穆苏克罗
雅芳	埃文
雅连	亚伦
雪柏	谢泼德
雪梨	悉尼
雪菲尔	谢菲尔德
雷伊泰岛	莱特岛 莱特湾
雷伊泰湾	莱特湾
雷伊泰省	莱特省
雷克斯汉姆	雷克瑟姆
雷克雅维克	雷克雅未克
雷吉纳	里贾纳
雷士廉	莱斯里普
雷格尼兹河	雷格尼茨河
雷湾	桑德贝
雷瓦登	吕伐登
霍尔斯坦	荷尔斯泰因
露明	洛蒙德
非百敦	锡巴顿
非里西亚	弗里西亚
韦卓	惠特彻奇
韦和夫	惠特沃斯
韦息士	威塞克斯
韦斯咸	西汉姆
韦根	威根
韦特史东	威尔德斯通
韩国	南韩
韩国与朝鲜	南韩与北韩
韩国以及朝鲜	南韩以及北韩
韩国及朝鲜	南韩及北韩
韩国同朝鲜	南韩同北韩
韩国和朝鲜	南韩和北韩
韩方	南韩方面
韩裔	南韩裔
须耳德	斯海尔德
顿内次	顿涅茨
顿内次克	顿涅茨克
顿内茨克	顿涅茨克
飞濑	飞屿
食品及农业部	食品和农业部
香贝里	尚贝里
马丁尼克	马提尼克
马丁尼兹	马丁内斯
马久罗	马朱罗
马什	马尔什
马凯	马尔凯
马利兰	马里兰
马利安纳	马里亚纳
马卡迪	马卡蒂
马哈地	马哈迪
马哈茂德	马末
马哈蒂尔	马哈迪
马士河	马斯河
马尔他	马耳他
马尔地夫	马尔代夫
马尔摩	马尔默
马布多	马普托
马德堡	马格德堡
马拉威	马拉维
马斯垂克	马斯特里赫特
马来西亚总理	马来西亚首相
马纳瓜	马那瓜
马赛鲁	马塞卢
骄宁咸	吉林汉姆
高云地利	考文垂
高士福	戈斯福德
高活	古德伍德 科尔伍德
高车士打	科尔切斯特
鲁安达	罗安达
鲁梅斯堡	鲁梅尔斯堡
鲁特	劳特
鸦兰	阿伦
鸭巴甸	阿伯丁
麦克墨雷	麦克默里
麦基尔	麦吉尔
麦德威	梅德韦
麦梅利	麦克默里
麦纳玛	麦纳麦
麦觉理	麦考瑞
麦赫连	梅赫伦
麻六甲	马六甲
麻省	马萨诸塞州
麻萨诸塞	马萨诸塞
麻萨诸塞州	马萨诸塞州
黄刀镇	耶罗纳夫
黑森林	黑林山
黑森邦	黑森州
黑池	布莱克浦
黑潭	布莱克浦
龙山山脉	德拉肯斯山脉
