128位元	128位
12位元	12位
16位元	16位
18位元	18位
2009年H1N1新型流感疫情	2009年H1N1流感大流行
2009年人类猪型流感疫情	2009年H1N1流感大流行
2019冠状病毒病	2019冠状病毒疾病
24位元	24位
31位元	31位
32位元	32位
36位元	36位
3D电影	三维电影
3D电脑	三维计算机
3D电脑图形	三维计算机图形
48位元	48位
4位元	4位
60位元	60位
64位元	64位
80位元	80位
8位元	8位
A型流感	甲型流感
A型肝炎	甲型肝炎
A磁碟机	A盘
BC正规形式	BC范式
B型流感	乙型流感
B型肝炎	乙型肝炎
B磁碟机	B盘
CP值	性价比
C型流感	丙型流感
C型肝炎	丙型肝炎
C磁碟机	C盘
DK规格化	DK范式
D型流感	丁型流感
D型肝炎	丁型肝炎
D磁碟机	D盘
E型肝炎	戊型肝炎
E磁碟机	E盘
F型肝炎	己型肝炎
F磁碟机	F盘
Google云端通讯	Google云消息传递
Google工具列	Google工具条
Google影片	Google视频
Google文件	Google文档
GSM流动	GSM移动
GSM行动	GSM移动
GUID磁碟分割表	全局唯一标识分区表
G型肝炎	庚型肝炎
G磁碟机	G盘
H1N1新型流感	甲型H1N1流感
H磁碟机	H盘
I磁碟机	I盘
Java的类别	Java的类
Java类别	Java类
J磁碟机	J盘
K磁碟机	K盘
L磁碟机	L盘
M磁碟机	M盘
NetBook	上网本
N磁碟机	N盘
O磁碟机	O盘
Podcast	播客
P磁碟机	P盘
Q磁碟机	Q盘
R磁碟机	R盘
SanDisk	闪迪
SARS	沙斯
S磁碟机	S盘
T磁碟机	T盘
Ultrabook	超极本
USB手指	U盘
USB磁碟机	U盘
USB随身碟	U盘
U磁碟机	U盘
V磁碟机	V盘
W磁碟机	W盘
X磁碟机	X盘
X视窗系统	X窗口系统
Y磁碟机	Y盘
Z磁碟机	Z盘
一元函式	单参函数
一型糖尿病	1型糖尿病
一级碳	伯碳
一级胺	伯胺
一级醇	伯醇
一补数	反码
一补码	反码
三一律	三分律
三元搜寻树	三叉搜索树
三元树	三叉树
三元连结串列	三叉链表
三叉搜寻树	三叉搜索树
三级碳	叔碳
三级胺	叔胺
三级醇	叔醇
三酰甘油	三酸甘油酯
上下文交换	上下文切换
下拉式清单	下拉列表
下拉式选单	下拉菜单
不偏	无偏
不断电系统	电源保护
不活化	灭活
专案	项目
世界流动通讯大会	世界移动通信大会
世界行动通讯大会	世界移动通信大会
丛集	集群
东亚夜蛛	东方长蟱蛛
东方长妩蛛	东方长蟱蛛
丢掷	抛出
两生纲	两栖纲
严重急性呼吸系统综合征冠状病毒2	严重急性呼吸综合征冠状病毒2
严重急性呼吸系统综合症	严重急性呼吸道综合征
严重急性呼吸综合症冠状病毒2型	严重急性呼吸综合征冠状病毒2
严重急性呼吸道症候群	严重急性呼吸道综合征
严重急性呼吸道症候群冠状病毒2型	严重急性呼吸综合征冠状病毒2
严重特殊传染性肺炎	2019冠状病毒疾病
个人区域网路	个人网
个人数位助理	个人数码助理
中介软体	中间件
中央极限定理	中心极限定理
中孔洞二氧化矽	介孔二氧化硅
中孔洞氧化矽	介孔氧化硅
中尾突木虱属	瘦木虱属
中阶	中端 中级
串流加密法	流密码
串流媒体	流媒体
主平方根	算术平方根
主开机纪录	主引导记录
主机板	主板
主档名	文件主名
主记忆体	主存
么元素	幺元素
么半	幺半
么正	幺正
么正矩阵	酉矩阵
么正空间	酉空间
么正群	酉群
乘数表	乘法表
乙太网路	以太网
乙醯柳酸	乙酰水杨酸
乙醯胺酚	对乙酰氨基酚
乱数	随机数
乱流	湍流
事前分布	先验分布
事前机率	先验概率
事后分布	后验分布
事后机率	后验概率
二元函数	双参函数
二元堆积	二叉堆
二元搜寻树	二叉搜索树
二元树	二叉树
二元连结串列	二叉链表
二叉堆积	二叉堆
二叉搜寻树	二叉搜索树
二名法	双名法
二型糖尿病	2型糖尿病
二极体	二极管
二次体	二次域
二级碳	仲碳
二级胺	仲胺
二级醇	仲醇
二维条码	二维码
二补数	补码
二补码	补码
云端储存	云存储
云端运算	云计算
互余	互馀
互动	交互
互变异构物	互变异构体
互斥并集	不交并
互斥或	异或
互斥联集	不交并
互联网内容供应商	互联网内容提供商
互联网服务供应商	互联网服务提供商
互联网金钥交换	因特网密钥交换
互质	互素
亚佛加厥	阿伏伽德罗
亚佛加厥常数	阿伏伽德罗常量
交互作用	相互作用
交叉共变数	互协方差
交谈循序程式	通信顺序进程
交谈识别码	会话标识
产品金钥	产品密钥
亮大蚊	沼大蚊
人工智能	人工智慧
人工肺	体外膜氧合
人机介面	人机界面 脑机接口
人类猪型流感	甲型H1N1流感
人面辨识	人脸识别
仁介壳虫科	仁蚧科
仄腹蜡蝉科	颖蜡蝉科
介电强度	电介质强度
介面	接口
代数封闭体	代数封闭域
代数独立	代数无关
代数相依	代数相关
代数闭体	代数闭域
代理人导向程式设计	面向代理编程
代管	托管
企业行动管理	企业移动管理
休克耳	休克尔
传短讯	发简讯
传简讯	发简讯
传送	发送
伤心小栈	红心大战
伪体染色体区	拟常染色体区
伫列	队列
伴细胞	伴胞
伺服器	服务器
伺服器端	服务端
伺服器讯息区块	服务器消息块
伽玛	伽马
伽罗瓦体	伽罗瓦域
位元串	位串
位元型样	位模式
位元栏	位段
位元组	字节
位元运算	位操作
位元速率	比特率
位元错误率	比特误码率
位址	地址
位能	势能
低画质	低清
低阶	低端 低级
低阶程式语言	低级编程语言
低阶语言	低级语言
佑位元组	尧字节
体扩张	域扩张
体抑素	生长抑素
体染色体	常染色体
体细胞超突变	体细胞高频突变
体论	域论
余代数	馀代数
余伦	上同伦
余像	馀像
余单纯	馀单纯
余因子	馀因子
余极限	馀极限
余核	馀核
余模	馀模
余法丛	馀法丛
余矢	馀矢
余纬度	馀纬度
余调	上同调
余键	上链
佛利民	弗里德曼
佛雷洛夫	弗廖罗夫
作业研究	运筹学
作业系统	操作系统
作了功	做了功
作功	做功
作变速率圆周运动	做变速圆周运动
作正功	做正功
作的功	做的功
作等速率圆周运动	做匀速圆周运动
作等速直线运动	做匀速直线运动
作等速运动	做匀速运动
作负功	做负功
使用者	用户
使用者介面	用户界面
使用者供应内容	用户生成内容
使用者名称	用户名
使用者方块	用户框
使用者群组	用户组
使用者页面	用户页
例外处理	异常处理
依值型别	依赖类型
依存型别	依存类型
促效剂	激动剂
促进性扩散	易化扩散
保安软件	安全软件
信号识别粒子	信号识别颗粒
信心水准	置信水平
信赖区间	置信区间
修复记录	恢复记录
修补程式	补丁
修饰词	修饰符
假性狂犬病	伪狂犬病
假柚叶藤	假石柑
假柚叶藤属	假石柑属
假皂荚属	扁核木属
假设检定	假设检验
假说检定	假设检验
偏好设定	首选项
停止追踪	请勿追踪
傅利曼	弗里德曼
傅立叶	傅里叶
傅里德曼	弗里德曼
储存	存储
储存格	单元格
储存程序	存储程序
僵直性脊椎炎	强直性脊柱炎
元程式设计	元编程
元资料	元数据
兆位元组	太字节
光学异构物	光学异构体
光碟	光盘
光碟机	光盘驱动器
光纤分散式数据介面	光纤分布式数据接口
光纤分散式资料介面	光纤分布式数据接口
光纤网路终端	光网络终端
克卜勒	开普勒
克希荷夫	基尔霍夫
克柏兰	科普兰
克耳文	开尔文
克里斯多福	克里斯托费尔
克里福	克利福德
入口网站	门户系统 门户网站
入门系统	门户系统
入门网站	门户网站
全像	全息
全域	全局
全屏幕	全屏
全屏幕手机	全面屏手机
全录	施乐
全形	全角
全球暖化	全球变暖
全球流动通讯系统协会	全球移动通信系统协会
全球行动通讯系统协会	全球移动通信系统协会
全球资讯网	万维网
全球资讯网协会	万维网联盟
全萤幕	全屏
全萤幕手机	全面屏手机
八元树	八叉树
八芝兰竹	米筛竹
公地流动网路	公共陆基移动网
公用陆上行动网路	公共陆基移动网
兰屿姑婆芋	热亚海芋
共享软体	共享软件
共变异数	协方差
共用	共享
共用资料夹	共享文件夹
关联式资料库	关系数据库
内容传递网路	内容分发网络
内建	内置
内联网	内部网 内部网络
内视镜	内窥镜
内送流量备援容错机制	多宿主
内部网路	内联网 内部网 内部网络
再利用合成	补救合成
再利用路径	补救途径
写死	硬编码
军配飞虱科	扁蜡蝉科
冷次	楞次
冷融合	冷聚变
净力	合力
净外力	合外力
准则	判据
减毒性疫苗	减毒活疫苗
减毒性病毒	减毒活病毒
减活	减毒活
减活疫苗	减毒活疫苗
减活病毒	减毒活病毒
凝聚体	凝聚态
几丁质	甲壳素
凡得瓦	范德瓦耳斯
凡得瓦力	范德华力
凡得瓦方程式	范德华方程
凡得瓦键	范德华键
凡特荷夫	范托夫
凭证	证书
函式	函数
函式程式语言	函数编程语言
函式语言程式设计	函数式编程
刀蛏属	剑蛏属
刀锋伺服器	刀片服务器
分割区	分区
分割压缩	分卷压缩
分圆体	分圆域
分散式	分布式
分裂体	分裂域
分页	标签页
切伦科夫	切连科夫
切应力	剪应力
切线束	切丛
列举	枚举
列举元	枚举器 枚举成员
列印	打印
刘维定理	刘维尔定理
初级主动运输	原发性主动运输
利他能	利他林
利牟芋属	崖角藤属
刺胳针	柳叶刀
刺针	柳叶刀
刺革菌	锈革孔菌
刽客	溃客
剖析器	分析器
剖腹	剖宫
剪下	剪切
剪贴簿	剪贴板
副档名	扩展名 文件扩展名
副甲状腺	甲状旁腺
副甲状腺激素	甲状旁腺激素
副甲状腺素	甲状旁腺激素
功能型手机	功能手机
功能电话	功能手机
加强剂	加强针
加护病房	重症监护室
动区	能层
动圈	能层
动态型别	动态类型
动态系结	动态绑定
动态系统	动力系统
动态编码率	可变码率
劳仑兹	洛伦兹
劳仑次	洛伦茨
勒壤得	勒让德
勒壤得转换	勒让德变换
勒沙特列	勒夏特列
勾点	钩子
勾股定理	毕氏定理
勾股数	毕氏数
包立	泡利
包量	左矢
化学亲合势	化学亲和势
化学亲和力	化学亲和势
北方印迹	Northern印迹
北方墨点	Northern印迹 北方印迹
匹配拉净	哌嗪
区块加密法	分组密码
区块链结	区块链接
区域网络	局域网
区域网路	局域网
医事放射师	放射技师
医疗观察	医学观察
十亿位元乙太网路	吉比特以太网
十字韧带	交叉韧带
升糖素	胰高血糖素
升阳电脑	Sun微系统
半形	半角
华生	沃森
协同运作	协作
协定	协议
单一登入	单点登录
单位元素	单位元
单位配置	分配单元
单体	单纯形
单体复形	单纯复形
单晶片	单片机
单核心	宏内核
单核球	单核细胞
单核白血球	单核细胞
单纯李氏群	单李群
单纯群	单群
单连结	单通道
南方印迹	Southern印迹
南方墨点	Southern印迹
南洋竹	吊丝球竹
博客	部落格
卜瓦松	泊松
卡氏带	凯氏带
卤炔	卤代炔 卤代炔烃
卤烯	卤代烯 卤代烯烃
卤烷	卤代烷 卤代烷烃
印表机	打印机
卵叶盐藻	喜盐草
卷动	滚动
卷动方块	滚动框
卷叶象鼻虫科	卷象科
卷轴	滚动条 滚动栏
压力	压强
压缩档	压缩包
厚角金龟科	隆金龟科
原型程式设计	基于原型的编程
原始档	源文件
原时	固有时
原生的	本地的
原生质丝	胞间连丝
原生质体内路径	共质体途径
原生质体内运输	共质体运输
原生质体外路径	质体外途径
原生质体外运输	质体外运输
去氢	脱氢
去氧	脱氧
去氧核糖	脱氧核糖
去氧羟四环霉素	多西环素 强力霉素 脱氧土霉素
去相干	退相干
去碘	脱碘
去辅基酶	脱辅基酶
参数列	参数列表 参数表
参数设置	首选项
参照	引用
叉木虱科	个木虱科
叉舌蛙科	叉舌蟾科
双氯恶唑西林	双氯西林
双连结	双通道
反元素	逆元
反曲点	拐点
反转录	逆转录
反链结	反链接
发短信	发简讯
发短讯	发简讯
取得	获取
取样率	采样率
受控代码	托管代码
受质	底物
受质级磷酸化	底物水平磷酸化
变动位元速率	可变码率
变叶姬旋花	毛山猪菜
变异数	方差
变数	变量
变构	别构
变速率圆周运动	变速圆周运动
叙述统计	描述统计
古典	经典
古典群	典型群
叩头虫	叩甲
可定址内容记忆体	内容可寻址存储器 结合存储
可延伸	可扩展
可延伸商用报告语言	可扩展商业报告语言
可延伸标示语言	可扩展置标语言
可延伸韧体介面	可扩展固件接口
可执行档	可执行文件
可携式	便携式
可携式文件格式	可移植文档格式
可携式版本	便携版
可携式软件	绿色软件
可携式软体	绿色软件
可程式化	可编程
可逆元素	可逆元
台湾电鲼	台湾电鳐
史丹佛	斯坦福
史丹吉氏斜鳞蛇	花尾斜鳞蛇
史丹福	斯坦福
史塔克	斯塔克
史拉斯基	斯卢茨基
史特姆	施图姆
史诺登	斯诺登
史达	斯塔尔
史顿一加立克实验	斯特恩一革拉赫实验
叶克膜	体外膜氧合
号志	信号量
司乃耳	斯涅尔
吉丁虫科	吉丁科
吉位元组	吉字节
吉贝素	赤霉素
同中素	同中子异荷素
同侧内角	同旁内角
同侧外角	同旁外角
同分异构物	同分异构体
同化类固醇	蛋白同化甾类
同量素	同量异位素
向量势	矢势
向量图形	矢量图形
启动	引导
启动切换	启动转换
启动列	启动栏
启动磁碟	启动盘
启动载入程式	启动引导程序
启用	激活
启用功能	激活函数
周期素	周期蛋白
呼叫	调用
呼叫层级介面	调用层接口
命令列	命令行
命令链结	命令链接
品质	质量
哈伯	哈勃
哏图	表情包
唯一定理	唯一性定理
唯写	只写
唯写记忆体	只写存储器
唯若	仅当
唯读	只读
唯读记忆体	只读存储器
商业模式	商业模型
啫喱豆	果冻豆
嗜中性球	中性粒细胞
嗜中性颗粒白血球	中性粒细胞
嗜曙红颗粒白血球	嗜酸性粒细胞
嗜硷性球	嗜碱性粒细胞
嗜硷颗粒白血球	嗜碱性粒细胞
嗜酸性球	嗜酸性粒细胞
嘉氏带	凯氏带
嚬哪醇	频哪醇
四元树	四叉树
四级碳	季碳
四级铵	季铵
回呼	回调
回圈	循环
回车字元	回车符
回音	回声
回馈	反馈
因数	约数
因果推论	因果推断
因次	量纲
围绕字元	带圈字符
固定位元速率	固定码率
固态物理学	固体物理学
固有函数	本征函数
图型识别	模式识别
图学	图形学
图形化使用者介面	图形用户界面
图档	图像文件
图片检视器	图片查看器
图示	图标
圆飞虱科	瓢蜡蝉科
土半夏	犁头尖
土半夏属	犁头尖属
在地化	本地化
地址列	地址栏
地胆科	芫菁科
均值定理	中值定理
均匀收敛	一致收敛
均匀有界原理	一致有界性原理
均匀空间	一致空间
均匀范数	一致范数
均匀连续	一致连续
均匀邻域	一致邻域
坏轨	坏道
块链结	组链接
坡印廷	坡印亭
型一错误	第一类错误
型二错误	第二类错误
型别检查	类型检查
型别系统	类型系统
埋葬虫科	葬甲科
埠	端口
培若	珀罗
基体	基域
基因剔除	基因敲除
基因表现	基因表达
基因转移	转基因
基本类型	基类型
基础类别	基类
基质	底物
基质水平磷酸化	底物水平磷酸化
基隆扁叶芋	台湾千年健
基频	基带
堆叠	堆栈
堆叠导向	面向堆栈
堆叠帧	堆栈帧
堆叠框	堆栈帧
堆积排序	堆排序
塌缩	坍缩
塑胶	塑料
墨点	印迹
处理常式	处理函数
复健医学	康复医学
复写	改写
复制	克隆
复原	撤销
复变数	复变量
复数平面	复平面
复杂度类别	复杂度类
复杂性类别	复杂性类
外挂程式	插件
外接硬碟	外置硬盘
外来键	外键
多代理系统	多主体系统
多变量分析	多元变量分析
多变量统计	多元变量统计
多变量统计分析	多元变量统计分析
多型	多态
多媒体短讯	多媒体简讯
多层次树状介面	分层树形视图 分层视图
多工	多任务
多样化互联网应用程式	丰富互联网应用程序
多样化网际网路应用程式	丰富互联网应用程序
多灭虫	多拉菌素
多白胺酸重复	富亮氨酸重复
多蕊仙人球	鸾凤玉
多角仙人球	瑞凤玉
多载	重载
多项式成长	多项式增长
多频道联播网	多频道网络
夜蛛属	长蟱蛛属
大一统理论	大统一理论
大区块	宏块
大型电脑	大型机
大域体	整体域
大数法则	大数定律
大菜	琼脂
大霹雳	大爆炸
大黄狐蛤	中国海大锉蛤
天使综合症	安格曼综合征
天门冬胺酸	天冬氨酸
天门冬醯胺	天冬酰胺
太阳电脑	Sun微系统
夫朗和斐绕射	夫琅禾费衍射
失智症	痴呆症
失真压缩	有损压缩
奇异点	奇点
契忍可夫	切连科夫
奥杰	俄歇
妩蛛科	蟱蛛科
姜黄反应	黄蛋白反应
姬蛛属	球蛛属
姬蛛科	球蛛科
威尔森	威耳孙
威悌	维蒂希
威腾电子	西部数据
娇生	强生
媒介	介质
媒体相依介面	介质相关接口
子体	子域
子网络	子网
子网络遮罩	子网掩码
子网路	子网
子网路遮罩	子网掩码
字串	字符串
字元	字符
字元产生器	字符生成器
字元列印机	字符打印机
字型	字体
字尾	后缀
字首	前缀
存取控制列表	访问控制表
存取点	接入点
守护行程	守护进程
安全软体	安全软件
安全通讯协定	安全套接层
安姆氏试验	埃姆斯试验
安格曼症候群	安格曼综合征
安比西林	氨苄青霉素
安装套件	安装包
安默西林	阿莫西林
官能基	官能团
定位域	定位框
定址	寻址
定址模式	寻址模式
定序	测序
实体位址	物理地址
实体层	物理层
实体记忆体	物理内存
实封闭体	实封闭域
实数轴	实轴
实证	循证
实证医学	循证医学
实证应用	循证实践
实闭体	实闭域
客制化	定制
室房间隔缺损	室间隔缺损
宽屏幕	宽屏
宽萤幕	宽屏
宽频	宽带
寄存	托管
富来他顿	呋喃它酮
富来顿	呋喃唑酮
富白氨酸重复	富亮氨酸重复
察卡夫	查戈夫
寨卡病毒	兹卡病毒
对射	双射
对应域	到达域
对映	映射
对立假设	备择假设
对立假说	备择假设
对等	点对点
对话方块	对话框
对谈	会话
寻找	查找
导来代数	导出代数
导来函子	导出函子
导来集	导集
导程	导联
导览列	导航条
封包	数据包
封包交换	分组交换
封锁	屏蔽
小儿麻痹症	脊髓灰质炎
小头飞虱科	颖蜡蝉科
小笔电	上网本
小蕈虫	小蕈甲
尖尾姑婆芋	尖尾芋
尼斯小体	尼氏体
尾端递回	尾部递归
局部体	局部域
局限融合	约束聚变
居礼	居里
山蓝桉	广叶桉
巢状	嵌套
工作切换	任务切换
工作列	任务栏
工作管理员	任务管理器
工作群组	工作组
工具列	工具栏
左右四美素	四咪唑
巨环内酯	大环内酯
巨观量	宏观量
巨集病毒	宏病毒
巴尔默	鲍尔默
布拉克系	布拉开线系
布拉菲	布拉维
布林	布尔
布林运算	布尔逻辑
布氏树蛙	布氏泛树蛙
布氏魁蛤	布氏蚶
布莱特	布赖特
布里元	布里渊
布鲁斯特角	布儒斯特角
帐号	账号
帐户	账户
帕松	泊松
帕金森氏症	帕金森病
常式	例程
常态	正态
常数	常量
常蚜科	蚜科
平均位元速率	平均码率
平均自由径	平均自由程
平大蚊	窗大蚊
平滑内质网	光面内质网
平行导向	面向并发
平行计算	并行计算
并列	并行
并列埠	并行端口
并行	并发
并行计算	并发计算
广告区	广告位
广域网路	广域网
序列埠	串口 串行端口
序列法则	顺序规则
序列计算	串行计算
序号产生器	注册机
库佛氏细胞	库普弗细胞
应变数	因变量
应变量	因变量
应用程式	应用程序
应用程式介面	应用程序接口
底线	下划线
康霉素	卡那霉素
延展实境	扩展现实
延迟股	后随链
建构函式	构造函数
建立	创建
建设性干涉	相长干涉
开放手机联盟	开放手持设备联盟
开放行动联盟	开放移动联盟
开机	引导
开机切换	启动转换
异位	别构
异构物	异构体
异白氨酸	异亮氨酸
异白胺酸	异亮氨酸
异营	异养
异质变异数	异方差
引子	引物
弗比尼斯	弗罗贝尼乌斯
弱型别	弱类型
弹出式视窗	弹出窗口
弹卡计	弹式量热器
弹式热量计	弹式量热器
强化子	增强子
强型别	强类型
当机	死机
当药属	獐牙菜属
录影带	录像带
彩信	多媒体简讯
彩现	渲染
影像处理器	视频处理器
影像端子	视频接口
影像记忆体	显存
影像输出	视频输出
影印	复印
影格	帧
影格同步化	帧同步
影格指标	帧指针
影格率	帧率
影片	视频
影片串流	影片流
影片档	视频文件 视频档
影音串流	影音流
征状	症状
待美嘧唑	二甲硝咪唑
微中子	中微子
微型部落格	微型博客
微扰	摄动
微部落格	微博客
德国麻疹疫苗	风疹疫苗
德威特	德维特
德汝德	德鲁德
心室中隔缺损	室间隔缺损
心房中隔缺损	房间隔缺损
心房利钠肽	心房钠尿肽
心房排钠肽	心房钠尿肽
心房间隔缺损	房间隔缺损
心脏超声波	超声心动图
心脏超音波	超声心动图
必欧	毕奥
必理痛	班纳杜
必理通	班纳杜
忒斯拉	特斯拉
快取	缓存
快取记忆体	缓冲存储器
快捷列	快捷工具栏
快捷半导体	飞兆半导体
快速键	快捷键
快闪记忆体	闪存
思觉失调症	精神分裂症
性联遗传	伴性遗传
性连锁遗传	伴性遗传
总体经济	宏观经济
恩氟奎林羧酸	恩诺沙星
悖论	佯谬
惠金斯原理	惠更斯原理
感测器	传感器
我的文件	我的文档
戴奥辛	二噁英
扁叶芋属	千年健属
扇网蛛	近亲三角蛛
扇网蛛属	三角蛛属
手提电脑	笔记本电脑
手稿语言	脚本语言
托列里桉	毛叶桉
执行绪	线程
执行长	首席执行官
扩充	扩展
扩充A區	扩展A区
扩充B區	扩展B区
扩充C區	扩展C区
扩充D區	扩展D区
扩充E區	扩展E区
扩充F區	扩展F区
扩充G區	扩展G区
扩充区	扩展区
扩充汉字	扩展汉字
扩增实境	增强现实
扩张体	扩张域
扩张实境	增强现实
扫描器	扫描仪
扭率	挠率
扭矩转换器	扭力变矩器 液力变矩器
批次	批量
批次处理	批处理
批次档	批处理文件
批次程式	批处理程序
技术长	首席技术官
投掷	抛出
抗发炎	抗炎
抗痉挛	抗惊厥
折角蛾	祝蛾
护理师	护士
披衣菌	衣原体
披衣菌门	衣原体门
抱卵亚目	腹胚亚目
抽取式	可移动
拂尾藻	草茨藻
拂尾藻属	茨藻属
拉午耳	拉乌尔
拉塞福	卢瑟福
拉瓦节	拉瓦锡
拉萨热	拉沙热
拍位元组	拍字节
拎树藤	麒麟叶
拎树藤属	麒麟叶属
拖曳	拖拽
拟步行虫科	拟步甲科
括量	右矢
指令式程式设计	命令式编程
指令码	脚本
指标	指针
按位元	按位
挥发性	易失性
捷径	快捷方式
排程	调度
排程器	调度器
接取多工器	接入复用器
接续互通	连续互通
控制代码	句柄
控制项	控件
推播	推送
搜寻	搜索
搜寻方块	搜索框
搜寻键码	搜索关键字
摄像放像机	摄像机
摄录影机	摄像机
摇摆硷基对	摆动碱基对
摇摆配对	摆动配对
摺积	卷积
支援	支持
效能	性能
数位	数字
数位凭证	数字证书
数位制图	数字测图
数位化	数字化
数位发行	数字发行
数位媒体	数字媒体
数位广播	数字广播
数位影像	数字图像
数位影片	数字视频
数位无线电视	数字地面电视
数位模式	数字模式
数位浮水印	数字水印
数位版权	数字版权
数位电视	数字电视
数位相机	数字相机
数位相片	数字照片
数位签章	数字签名
数位行动	数字移动
数位资产	数字资产
数位身分	数字身份
数体	数域
数据市集	数据集市
数据探勘	数据挖掘
数据机	调制解调器
数码制图	数字测图
数码化	数字化
数码发行	数字发行
数码图像	数字图像
数码地面电视	数字地面电视
数码媒体	数字媒体
数码广播	数字广播
数码影片	数字视频
数码模式	数字模式
数码水印	数字水印
数码流动	数字移动
数码版权	数字版权
数码电视	数字电视
数码相机	数字相机
数码相片	数字照片
数码签章	数字签名
数码证书	数字证书
数码资产	数字资产
数码身份	数字身份
整合	集成
整合式开发环境	集成开发环境
整合装置电路	集成设备电路
整块性核心	宏内核
文书处理	文字处理
文书处理器	文字处理器
文介面	文界面
文件导向	面向文档
文件档案	文档文件
文件物件模型	文档对象模型
文字方块	文本框
文字档案	文本文件
文字编辑器	文本编辑器
斑桉	斑皮桉
斑腿树蛙	斑腿泛树蛙
斯涅耳	斯涅尔
斯特凡	斯特藩
斯特尔	斯塔尔
斯特恩	施特恩
新帝	闪迪
方块图	框图
方程式	方程
施瓦次	施瓦兹
旋光异构体	光学异构体
族群	种群
无失真	无损
无失真压缩	无损压缩
无尽不循环小数	无限不循环小数
无尽小数	无限小数
无尽循环小数	无限循环小数
无母数	非参数
无痕模式	隐身模式
无线广播	地面广播
无线电视	地面电视
无线电钮	单选按钮
时脉频率	时钟频率
易辛	伊辛
映像管	显像管
显示卡	显卡
显著性水平	显著水平
显著水准	显著水平
普拿疼	班纳杜
晶场	晶体场
晶片	芯片
智慧化	智能化
智慧型	智慧
智慧型喇叭	智能音箱
智慧型手机	智能手机
智慧型手表	智能手表
智慧型电视	智能电视
智慧财产权	知识产权
智能	智慧
智能卡	智慧卡
暂存器	寄存器
最佳化	优化 最优化
最小平方	最小二乘
最末层衍生类别	最底层派生类
有尽不循环小数	有限不循环小数
有尽小数	有限小数
有尽循环小数	有限循环小数
有序体	有序域
有星属	星球属
有限体	有限域
服务器阵列	伺服器阵列
服务架构	服务框架
朗缪耳	朗缪尔
本机磁碟(A)	A盘
本机磁碟(B)	B盘
本机磁碟(C)	C盘
本机磁碟(D)	D盘
本机磁碟(E)	E盘
本机磁碟(F)	F盘
本机磁碟(G)	G盘
本机磁碟(H)	H盘
本机磁碟(I)	I盘
本机磁碟(J)	J盘
本机磁碟(K)	K盘
本机磁碟(L)	L盘
本机磁碟(M)	M盘
本机磁碟(N)	N盘
本机磁碟(O)	O盘
本机磁碟(P)	P盘
本机磁碟(Q)	Q盘
本机磁碟(R)	R盘
本机磁碟(S)	S盘
本机磁碟(T)	T盘
本机磁碟(U)	U盘
本机磁碟(V)	V盘
本机磁碟(W)	W盘
本机磁碟(X)	X盘
本机磁碟(Y)	Y盘
本机磁碟(Z)	Z盘
朱克伯格	扎克伯格
机上盒	机顶盒
机器码	机器代码
机械码	机器代码
机率	几率 概率
杂凑	散列
杂讯	噪声
权杖	令牌
条斑蝇虎属	蝇虎属
构筑原理	构造原理
柏克莱软件套件	伯克利软件套件
柏克莱软体套件	伯克利软件套件
柏拉图	帕雷托
柏金逊症	帕金森病
柚叶藤	石柑子
柚叶藤属	石柑属
柚叶藤族	石柑族
查兑克	查德威克
查加夫	查戈夫
柯弗氏细胞	库普弗细胞
柯霍氏法则	科赫法则
柴比雪夫	切比雪夫
柴瑟夫	查依采夫
标准画质	标清
标头档	头文件
标示语言	标记语言 置标语言
标题列	标题栏
栏位	字段
树状细胞	树突状细胞
树突细胞	树突状细胞
校园网络	校园网
校园网路	校园网
栲属	锥栗属
核分裂	核裂变
核取按钮	复选按钮
核取方块	复选框
核对位元	检验位
核对和	检验和
核磁共振谱学	核磁共振波谱法
核磁谐振谱学	核磁共振波谱法
核种	核素
核融合	核聚变
核转换	核嬗变
格线	网格线
格雷姆	格锐目
桀威	捷威
桂皮醛	肉桂醛
框同步化	帧同步
框指标	帧指针
桌上型	桌面型
桌上型电脑	台式机
桌上电脑	台式机
桌布	壁纸
档名	文件名
档头	标头
档案	文件
档案名字	文件名字
档案名称	文件名称
档案命名空间	文件命名空间
档案总管	资源管理器
档案描述子	文件描述符
桥脑	脑桥
梁山慈	大叶慈
梅属	李属
梅斯堡	穆斯堡尔
梅瑟生	梅塞尔森
梗塞	梗死
检定	检验
检定力	统计功效
检视	查看
棘涡蛛	刺涡蛛
棘状层	棘层
棘蛋白	刺突蛋白
棣美弗	棣莫弗
概似	似然
模拟实境	模拟现实
模组	模块
横纹蝇虎	横纹蝇狮
横荧幕	横屏幕
横萤幕	横屏幕
樱毛蕈虫科	缨甲科
橙黄蝇虎	黑猫跳蛛
次原子	亚原子
次常式	子例程
次级主动运输	继发性主动运输
次阻尼	欠阻尼
欧尼斯特	欧内斯特
欧本海默	奥本海默
正交补余	正交补
正向链结	前向链接
正向错误校正	前向纠错
正子电子偶	电子偶素
正肾上腺素	去甲肾上腺素
正规表示式	正则表达式
正规语言	正则语言
步行虫	步甲
死结	死锁
残留误差	误差
母体	总体
比得诺兹	贝德诺尔茨
比特	位元
毕氏三元数	勾股数 毕氏数
毛叶盐藻	毛叶喜盐草
气喘	哮喘
氟灭菌	氟甲喹
氟甲磺氯霉素	氟甲砜霉素 氟苯尼考
氟苯并嘧唑氨基甲酸	氟苯达唑
氢融合	氢聚变
氦融合	氦聚变
氨基泰霉素	替米考星
氯化奎宁	氯喹
氯四环霉素	金霉素
氯恶唑西林	邻氯青霉素
水芭蕉属	沼芋属
永续性	持久性
求余	求馀
汇入	导入
汇出	导出
汇流排	总线
汉他病毒	汉坦病毒
汤姆森	汤姆孙
汤姆生	汤姆孙
沃克	沃尔克
沙伐	萨伐尔
沙卡洛夫	萨哈罗夫
沙哈诺夫	萨哈罗夫
沙士	沙斯
沾黏	粘连
法兰克	弗兰克
法布立	法布里
泡沫塑胶	泡沫塑料
泡沫排序	冒泡排序
波以耳	波义耳
波兹曼	玻尔兹曼
波兹曼常数	玻尔兹曼常数
波向量	波矢
波恩	玻恩
波耳	玻尔
波耳磁元	玻尔磁子
注脚	脚注
泰妙素	泰妙菌素
泰霉素	泰乐菌素
洋菜	琼脂
洛以得镜	洛埃境
洪德定则	洪德规则
洪特规则	洪德规则
活化	激活
活化剂	激活剂
活性减毒	减毒活
活性因子	活度因子
活性系数	活度系数
活结	活锁
流动互联网	移动互联网
流动产品	移动产品
流动代理	移动代理
流动作业系统	移动操作系统
流动公司	移动公司
流动平台	移动平台
流动广播	移动广播
流动应用	移动应用
流动性	移动性
流动支付	移动支付
流动数据	移动数据
流动浏览器	移动浏览器
流动版	移动版
流动用户端	移动客户端
流动电脑	移动计算机
流动电视	移动电视
流动电讯	移动电信
流动电讯营办商	移动电信运营商
流动电话	移动电话
流动硬碟	移动硬盘
流动程式码	移动代码
流动端	移动端
流动终端	移动终端
流动网络	移动网络
流动网络营办商	移动网络运营商
流动营办商	移动运营商
流动装置	移动设备
流动资讯器材定义档	移动信息设备配置文件
流动软件	移动软件
流动通讯	移动通信
流动通讯开放制式联盟	开放移动联盟
流行性脑脊髓膜炎	流脑
流行性脑脊髓膜炎（A型）	A群流脑
流行性脑脊髓膜炎（C型）	C群流脑
浏览域	浏览框
浏览量	访问量
浮水印	水印
浮萍属	紫萍属
海芋	马蹄莲
海马回	海马体
海龙	哈龙
消去反应	消除反应
消去法	消元法
涛微中子	τ中微子
涡蛛科	蟱蛛科
液胞	液泡
淀粉样蛋白	淀粉样物质
深切治疗部	重症监护室
混合实境	混合现实
混合疫苗	结合疫苗
混成	杂化
清除快取	清理缓存
渐逝波	隐失波
渗泌汗腺	外泌汗腺
温瑞尔	风河
游标	光标
游离	电离
游离能	电离能
游离辐射	电离辐射
源代码	原始码
溢位	溢出
溶体	溶酶体
滋养体	活动体
滑鼠	鼠标
滚轴	滑块
滤泡	卵泡
演算法	算法
潘洛斯	彭罗斯
激光	镭射
灰桉	斑叶桉
点选	点击
点阵图	位图
烧录	刻录
爬虫类	爬行类
爬虫纲	爬行纲
爱拉托散尼	埃拉托斯特尼
爱灭虫	伊维菌素
父类别	父类
版权	著作权
牙虫科	牙甲科
物件	对象
物件导向	面向对象
物件导向程式设计	面向对象编程
物量	物质的量
特丽霓虹	特丽珑
状态列	状态栏
狂牛症	疯牛病
狄默夫	棣莫弗
玉山箭竹	玉山竹
玉山箭竹属	玉山竹属
王氏树蛙	王氏原指树蛙
玛莉	玛丽
玛莉亚	玛丽亚
玩家共和国	玩家国度
玫瑰桉	大桉
瑞立	瑞利
瓢虫科	瓢甲科
瓶刷子树属	红千层属
甘油三酸酯	三酸甘油酯
用户介面	用户界面
由下而上	自底向上
电位	电势
电信业者	电信运营商
电动游戏	视频游戏
电双级	电偶极子
电子信箱	邮箱
电子试算表	电子表格
电子邮件	电邮
电弱交互作用	弱电相互作用
电弱相互作用	弱电相互作用
电洞	空穴
电浆	等离子体
电浆体	等离子体
电浆态	等离子态
电脑合成影像	电脑产生图像
电脑断层扫描	计算机断层成像
电脑架构	计算机体系结构
电荷质量比	荷质比
电讯业	电信业
电讯供应商	电信运营商
电讯公司	电信公司
电讯商	电信商
电讯服务	电信服务
电讯行业	电信行业
电负度	电负性
电鲼	电鳐
畜福	头孢噻呋
疑难排解	疑难解答
疯牛症	疯牛病
症候群	综合症
痢疾阿米巴	溶组织内阿米巴
登入	登录
登录档	注册表
登革热	骨痛热症
白努利	伯努利
白千层属	千层树
白喉破伤风全细胞性百日咳混合疫苗	全细胞百白破疫苗
白喉破伤风混合疫苗	白破疫苗
白喉破伤风百日咳	百白破
白喉破伤风百日咳混合	百白破三联
白喉破伤风非细胞性百日咳混合疫苗	无细胞百白破疫苗
白氨酸	亮氨酸
白氨醯	亮氨酰
白胺酸	亮氨酸
白胺醯	亮氨酰
白血球	白细胞
百万位元组	兆字节
百金属	百金花属
皆位元组	泽字节
皮尔森	皮尔逊
皮耶	皮埃尔
皱褶	嵴
盐风桉	葡萄桉
监视	监控
盖兹	盖茨
盖格计数器	盖革计数器
目前版本	当前版本
目标使用者	目标用户
目标码	目标代码
目标软体	目标软件
目标集合	目标集
目的码	目标代码
目贼芋属	岩芋属
直译器	解释器
直译语言	解释型语言
相互资讯	互信息
相容	兼容
相机手机	照相手机
相片	照片
相簿	相册
盾介壳虫科	盾蚧科
盾背蝽科	盾蝽科
真实模式	实模式
短信	简讯
短影音	短视频
短讯	简讯
矽	硅
矽藻	硅藻
矽藻土炸药	硝酸甘油炸药
码产生器	代码生成器
砈	砹
砍站	扒站
破坏性干涉	相消干涉
硝化甘油	硝酸甘油
硬体	硬件
硬碟	硬盘
硬碟机	硬盘驱动器
硬碟阵列	硬盘阵列
确认键	回车键
碎形	分形
碧眼树蛙	碧眼原指树蛙
磁共振造影	磁共振成像
磁力共振扫描	磁共振成像
磁区	扇区
磁域	磁畴
磁头损坏	磁头划碰
磁碟	磁盘
磁碟机	磁盘驱动器
磁碟机代号	盘符
磁碟重组	磁盘碎片整理
磁碟重组工具	磁盘碎片整理程序
磁碟阵列	磁盘阵列
磁轨	磁道
社交媒体	社会媒体
社群媒体	社会媒体
社群网站	社交网站
社群网路	社交网络
祖克柏	扎克伯格
神经胺酸	神经氨酸
神麴	神曲
离层素	脱落酸
离胺酸	赖氨酸
种系发生学	系统发生学
积体电路	集成电路
积动差	积矩
稀有气体	惰性气体
程序化	过程化
程序导向	面向过程
程序式	过程式
程式	程序
程式设计	程序设计
程式设计师	程序员 程序编写员
程式设计范式	编程范型
程式语言	编程语言
稻虱科	飞虱科
稽核	审核
空串列	空列表
空字串	空串
穿隧	隧穿
窄频	窄带
立体异构物	立体异构体
章节附注	尾注
笔记型电脑	笔记本电脑
笛卡儿	笛卡尔
符记	权标
第1型糖尿病	1型糖尿病
第2型糖尿病	2型糖尿病
第一型错误	第一类错误
第一规格化	第一范式
第三正规化	第三范式
第二型错误	第二类错误
第二正规化	第二范式
第五规格化	第五范式
第六规格化	第六范式
第四规格化	第四范式
等位线	等势线
等速率圆周运动	匀速圆周运动
等速直线运动	匀速直线运动
等速运动	匀速运动
签章	签名
简报	演示稿
管线	流水线
箭形蝇虎	长腹蒙蛛
类体	类域
类别为基	基于类
类别为基的程式设计	基于类的编程
类别变数	类变量
类别定义	类定义
类别实例	类实例
类别宣告	类声明
类别导向	面向类
类别成员	类成员
类别方法	类方法
类别模板	类模板
类别的实例	类的实例
类别的建构函数	类的构造函数
类别的破坏函数	类的析构函数
类别载入器	类加载器
类别馆	类库
类比	模拟
类比广播	模拟广播
类比电视	模拟电视
类淀粉蛋白	淀粉样物质
类神经	人工神经
类铎受体	Toll样受体
粒线体	线粒体
粗糙内质网	粗面内质网
粗脚姬蛛属	阿内蛛属
精灵	向导
精神官能症	神经症
糖解	糖酵解
糖质新生	糖异生
系结	绑定
系统减敏感	系统脱敏
系统性回顾	系统综述
系统磁碟	系统盘
系统磁碟机	系统盘
系统记忆体保护	数据执行保护
索尼流动	索尼移动
索尼流动通讯	索尼移动通信
索尼行动	索尼移动
索尼行动通讯	索尼移动通信
索引标签	选项卡
紫芳草属	藻百年属
紫苏草	中华石龙尾
紫质	卟啉
繖花菜栾藤	伞花茉栾藤
红血球	红细胞
纪录档	日志
纯量	标量
纯量势	标势
纯量曲率	数量曲率
线上	在线
线上内容提供者	互联网内容提供商
线上异动处理	联机交易处理
线上影片	在线视频
线形动物门	线形虫动物门
线性独立	线性无关
线性相依	线性相关
组合方块	组合框
组合语言	汇编语言
组态	排布 配置
组态档	配置文件
组织胺	组胺
组织蛋白	组蛋白
组胺酸	组氨酸
组译	汇编
细栉角虫科	扇角甲科
细精管	生精小管
终端使用者	最终用户
终端使用者授权协定	最终用户许可协议
终端使用者授权合约	最终用户许可协议
终端子	终结器
结实压缩	固实压缩
结束应用程序	退出应用程序
结束应用程式	退出应用程序
结束程式	退出程序
绕射	衍射
绘图计算机	图形计算器
给吕萨克	盖
统一著色器架构	统一渲染架构
统合分析	元分析
统计推论	统计推断
统计杂讯	统计噪声
维他命	维生素
维因	维恩
维腾	威滕
综合征	综合症
缈中微子	μ中微子
缈子	μ子
缈微中子	μ中微子
缓冲区	缓冲器
缓冲区溢位	缓存溢出
编辑列	编辑栏
缘脊叶蝉科	脊冠叶蝉科
缟飞虱科	脉蜡蝉科
缠结	纠缠
缩图	缩略图
缩小绦虫	缩小膜壳绦虫
缩排	缩进
缩网址	缩略网址
网上欺凌	网络欺凌
网友	网民
网咖	网吧
网址列	地址栏
网宇实体系统	信息物理系统
网志	部落格
网景领航员	网景导航者
网状式资料库	网状数据库
网站识别钮	站点标识按钮
网络摄影机	摄像头
网络硬碟	网络硬盘
网络营办商	网络运营商
网络资料库	网状数据库
网路	网络
网路上的芳邻	网上邻居
网路业者	网络运营商
网路动画	网络动画
网路影片	在线视频
网路摄影机	摄像头
网路漫画	网络漫画
网路硬碟	网盘 网络硬盘
网路购物	网络购物
网路霸凌	网络欺凌
网际网路	互联网
网际网路服务提供者	互联网服务提供商
网际网路金钥交换	因特网密钥交换
罗必达	洛必达
羊毛脂固醇	羊毛甾醇
美国线上	美国在线
羟氯奎宁	羟氯喹
群组	组群
群组提示	组提示
耗能力	耗散力
职业治疗	康复治疗
职能治疗	康复治疗
联络	联系
联络人	联系人
联集	并集
聚醣	聚糖
肝糖储积症	糖原贮积症
肾元	肾单位
胃食道逆流	胃食管反流病
背景执行	后台运行
背景流量	后台流量
背条虫	条脊甲
胞器	细胞器
胺基	氨基
胺基酸	氨基酸
胺肽酶	氨肽酶
胺酸	氨酸
能阶	能级
脂桉	小帽桉
脑垂腺	垂体 脑下垂体 脑垂体
脑退化症	痴呆症
脱去反应	消除反应
脱氧羟四环霉素	多西环素 强力霉素 脱氧土霉素
脸书	面簿
脸谱	面簿
脸部辨识	人脸识别
膝形涡蛛	结实腰蟱蛛
自守式	自守形式
自我回归	自回归
自我相关	自相关
自营	自养
自订	自定义
臭肚鱼	蓝子鱼
致电离辐射	电离辐射
船魁蛤	榛蚶
色斯金	萨斯坎德
艾位元组	艾字节
艾氏树蛙	琉球原指树蛙
艾狄胥	埃尔德什
艾美氏试验	埃姆斯试验
芮得柏	里德伯
苏士侃	萨斯坎德
若且唯若	当且仅当
苯二氮平	苯二氮䓬
苯甲基	苄基
苯骈	苯并
范例	示例
范式	范型
范德华	范德瓦耳斯
范德华引力	范德华力
范德华方程式	范德华方程
范特霍夫	范托夫
茎胫	秆柄
茨竹	印度簕竹
荧幕	屏幕
荧幕保护装置	屏幕保护程序
荧幕撷取	截屏
药剂师	药师
莫斯利	莫塞莱
莫耳	摩尔
莫耳分率	摩尔分数
莱斯纳	雷斯勒
莱欧维尔	刘维尔
菊式链结	菊花链接
菊虎科	花萤科
菜栾藤	金花鱼黄草
菱蛛属	丘腹蛛属
菱飞虱科	菱蜡蝉科
菲涅耳绕射	菲涅耳衍射
菲蛛属	喜蟱蛛属
菸硷酸	烟酸
菸硷醯胺	烟酰胺
萤幕	屏幕
萤幕保护装置	屏幕保护程序
萤幕撷取	截屏
营运总监	首席运营官
营运长	首席运营官
著作权资讯	著作权信息
葛瑞夫兹氏病	格里夫氏症
葡萄球菌激酶	金葡菌激酶
蒙地卡罗	蒙特卡洛
蒲金耶氏纤维	浦肯野纤维
蒸散	蒸腾
蓝画面死机	蓝屏死机
蓝白当机	蓝屏死机
蓬莱竹	孝顺竹
蓬莱竹属	簕竹属
蕈蛾科	谷蛾科
薛丁格	薛定谔
蘑菇多糖	香菇多糖
虎克	胡克
虚拟函式	虚函数
虚拟机器	虚拟机
虚拟码	伪代码
虚拟私人网路	虚拟专用网
虚拟记忆体	虚拟内存
虚数轴	虚轴
虚无假设	零假设
虚无假说	零假设
蛋白质体	蛋白质组
蛤蟆蛛属	蛤莫蛛属
蜂巢式数据	蜂窝数据
蜂巢式网络	蜂窝网络
蜂巢式网路	蜂窝网络
蜂巢式资料	蜂窝数据
蝇虎科	跳蛛科
融合反应	聚变反应
血基质	血红素
血管收缩素	血管紧张素
行事历程式	日历程序
行内	内联
行动业者	移动运营商
行动产品	移动产品
行动代理	移动代理
行动作业系统	移动操作系统
行动公司	移动公司
行动内容管理	移动内容管理
行动平台	移动平台
行动广播	移动广播
行动应用	移动应用
行动应用管理	移动应用管理
行动性	移动性
行动支付	移动支付
行动浏览器	移动浏览器
行动版	移动版
行动用户端	移动客户端
行动电信	移动电信
行动电信业者	移动电信运营商
行动电源	移动电源
行动电脑	移动计算机
行动电视	移动电视
行动电话	移动电话
行动硬碟	移动硬盘
行动程式码	移动代码
行动端	移动端
行动终端	移动终端
行动网路	移动网络
行动网路业者	移动网络运营商
行动网路装置	移动联网设备
行动网际网路	移动互联网
行动联网装置	移动联网设备
行动装置	移动设备
行动装置管理	移动设备管理
行动资料	移动数据
行动资讯装置设定档	移动信息设备配置文件
行动软体	移动软件
行动通讯	移动通信
行政总裁	首席执行官
行程控制表	进程控制块
行程群组	进程组
行程间	进程间
行程间通讯	进程间通信
行销	营销
衍化列	继承列表
衍生	派生
衍生类别	派生类
衍生类型	派生类型
表单	窗体
表玻璃	表面皿
表面玻璃	表面皿
裂解酶	裂合酶
装置	设备
装饰仙人球	般若
西方印迹	Western印迹
西方墨点	Western印迹
观音座莲	莲座蕨
规格化	规范化
视像会议	视频会议
视光师	验光师
视窗管理员	窗口管理器
视觉化	可视化
视讯会议	视频会议
视讯档	视频文件 视频档
视讯档案	视频文档
视讯记忆体	显存
视讯轨	视频轨
视讯输入	视频输入
视讯输出	视频输出
视讯连接头	视频接口
角胸泥虫科	擎爪泥甲科
解像度	分辨率
解构	析构
解构函式	析构函数
解析度	分辨率
解离	离解
解离酶	裂合酶
解除参照	解引用
解除安装	卸载
解除规格化	反规范化
解题系统	评测系统
触控式萤幕	触摸屏
触控板	触摸板
触控萤幕	触屏
计数机	计算器
计画页	项目页
计算机科学	电脑科学
认知障碍症	痴呆症
讨论区	论坛
讯号	信号
讯号量	信号量
讯息	信息 消息
讯息传递	信号转导
讯息导向	面向消息
讯息导向中介层	面向消息的中间件
讯息方块	消息框
讯息确认颗粒	信号识别颗粒
讯息鉴别码	消息认证码
记忆体	存储器
记忆体漏失	内存泄漏
记忆卡	存储卡
记忆晶片	存储芯片
设定	设置
设定档	配置文件
设定运算子	赋值运算符
识别码	标识符
语意	语义
语意网	语义网
语法突显	语法高亮
语言套件	语言包
语言导向程式设计	面向语言的程序设计
说明与支援	帮助与支持
说明文件	帮助文档
诺顿魅影系统	诺顿克隆精灵
读卡机	读卡器
读我档案	自述文件
调色盘	调色板
谷固醇	谷甾醇
谷草转胺酶	谷草转氨酶
豆固醇	豆甾醇
象鼻虫科	象甲科
贝他	贝塔
贝克勒	贝克勒尔
贝兹曲线	贝塞尔曲线
贝氏估计	贝叶斯估计
贝氏定理	贝叶斯定理 贝叶斯法则 贝叶斯理论
贝氏推论	贝叶斯推断
贝氏机率	贝叶斯概率
贝氏统计	贝叶斯统计
贝祖	裴蜀
质体	质粒
质元素	素元
质因子	素因子
质因数	素因数
质性	素性
质数	素数
质数测试	素性测试
质环	素环
质理想	素理想
质素	质量
贪婪法	贪心法
贪婪演算法	贪心算法
贴上	粘贴
贴文	帖子
贵气体	惰性气体
费氏数列	斐波那契数列
费波纳契	斐波纳契
费米阶	费密能级
费雪	费希尔
贾伯斯	乔布斯
资料中心	数据中心
资料仓储	数据仓库
资料净化	数据清洗
资料包含	数据包含
资料包括	数据包括
资料夹	文件夹
资料市集	数据集市
资料库	数据库
资料报	数据报文
资料挖掘	数据捕捞
资料探勘	数据挖掘
资料来源	数据源
资料框	数据帧
资料类型	数据类型
资料链结	数据链接
资源回收筒	回收站
资讯	信息
资讯参与	信息接触
资讯及通讯科技	信息及通信技术
资讯学	信息学
资讯安全	信息安全
资讯工业	信息产业
资讯年代	信息时代
资讯总监	首席信息官
资讯时代	信息时代
资讯科学	信息学
资讯科技	信息技术
资讯管理	信息管理
资讯超载	信息过载
资讯长	首席信息官
赤藻糖	赤藓糖
赤藻酮糖	赤藓酮糖
赫士	盖斯
超文件标示语言	超文本标记语言 超文本置标语言
超极致笔电	超极本
超程式设计	元编程 超编程
超音波	超声波
跨性别荷尔蒙治疗	跨性别激素疗法
路径连通	道路连通
跳脱	转义
踩地雷	扫雷
身分	身份
轨域	轨道
轨态	轨道
转换	变换
转接蛋白	接头蛋白
转胺酶	转氨酶
转译	翻译
软件套件	软件包
软件套件管理系统	软件包管理系统
软件开发套件	软件开发工具包
软件流程	软件过程
软体	软件
软体套件	软件包
软体套件管理系统	软件包管理系统
软体开发套件	软件开发工具包
软体流程	软件过程
软碟	软盘
软碟机	软盘驱动器
轴元	主元
轻触	触摸
轻触式荧幕	触摸屏
轻触荧幕	触屏
载入	加载
辅助记忆码	助记符
辉达	英伟达
辨识	识别
迅子	快子
过氙酸	高氙酸
过氧化体	过氧化物酶体
过氯酸	高氯酸
过溴酸	高溴酸
过碘酸	高碘酸
过程控制段	进程控制块
过鎝酸	高锝酸
过铼酸	高铼酸
过锰酸	高锰酸
迈克生	迈克耳孙
迈射	激微波
运算元	操作数
运算子	运算符
运算物件	操作对象
还原光碟	恢复光盘
进阶	高级
远端	远程
远端桌面协定	远程桌面协议
远端程序呼叫	远程过程调用
连心力	有心力
连环新接龙	蜘蛛纸牌
连线分析处理	联机分析处理
连线劫持	会话劫持
连结	链接
连结串列	链表
连锁反应	链反应 链式反应
连锁律	链式法则
退伍军人病	军团病
适合度	拟合优度
选单	菜单
递回	递归
递回关系	递推关系
递建原理	构造原理
递归关系	递推关系
递移	传递
通用序列汇流排	通用串行总线
通行码鉴别协定	密码认证协议
通讯埠转发	端口转发
通讯层	套接层
通讯端	套接字
通配符	万用字元
逻辑卷轴管理	逻辑卷管理
逻辑装置	逻辑器件
逻辑闸	逻辑门
逾时	超时
遗失	丢失
遮蔽	屏蔽
邦佛洛尼	邦费罗尼
邮寄清单	邮件列表
邻近感测器	接近传感器
郝斯多夫	豪斯多夫
郭公虫	郭公甲
都会网路	城域网
都卜勒	多普勒
配位基	配体
配接器	适配器
酮酸血症	酮症酸中毒
醣基化	糖基化
醣苷基	糖基
醯	酰
醯胺	酰胺
重力波	引力波
重复群	重复组
重新启动	重启
重新命名	重命名
重新安装	重装
重新导向	重定向
重新导向页面	重定向页
重新整理	刷新
重新整理频率	刷新率
重设	重置
量子位元	量子比特
金姬蛛属	丽蛛属
金氧半导体	金属氧化物半导体
金花虫科	叶甲科
金蛛科	园蛛科
金钥	密钥
金龟子科	金龟科
鉨	鿭
鉲	锎
鉳	锫
鋂	镅
錼	镎
鍅	钫
鎝	锝
鑀	锿
钙离子通道	钙通道
钙讯号	钙信号
钠钾帮浦	钠钾泵
钩吻鲑属	麻哈鱼属
钸	钚
铁酸	高铁酸
铜箔基板	复铜板
铭印	印记
链介壳虫	链蚧
链结反向	链接反向
链结搜寻	链接搜索
链结正向	链接正向
错合物	复合物 络合物 配合物
错离子	复离子 络离子 配离子
锥大蚊	烛大蚊
锦葵木虱科	裂木虱科
键盘配置	键盘布局
锹形虫科	锹甲科
镏	镥
镭射影碟	激光视盘
镶嵌病毒	花叶病毒
长夜蛛	长蟱蛛
长妩蛛	长蟱蛛
长妩蛛属	长蟱蛛属
长翅飞虱科	袖蜡蝉科
长花蚤	毛泥甲
门得列夫	门捷列夫
闭图定理	闭图像定理
间质隔离	基体分离
间隔缺损	中隔缺损
闵考斯基	闵可夫斯基
闸道器	网关
防写	写保护
防毒	杀毒
阵列	数组
阵列服务器	阵列伺服器
阵列硬碟	阵列硬盘
阶层	层次结构
阻断服务	拒绝服务
阿佛加德罗	阿伏伽德罗
阿佛加德罗常数	阿伏伽德罗常量
阿士匹灵	阿司匹林
阿尔茨海默病	阿兹海默症
阿拉伯芥	拟南芥
阿斯匹灵	阿司匹林
阿瑞尼士	阿伦尼乌斯
附加元件	附加组件
陈述式	语句
除余	除馀
除错	调试
陶中微子	τ中微子
陶子	τ子
隆背菲蛛	隆喜蟱蛛
随插即用	即插即用
隐翅虫科	隐翅甲科
隐藏式马可夫模型	隐马尔可夫模型
雪梨蓝桉	柳叶桉
零元素	零元
雷射	镭射
雷射影碟	激光视盘
雷根糖	果冻豆
青萍属	浮萍属
静不定	超静定
静态型别	静态类型
非典	沙斯
非同步	异步
非类固醇抗发炎药	非甾体抗炎药
面天树蛙	面天原指树蛙
革利士	格里斯
革拉赫	格拉赫
鞋魁蛤	偏胀蚶
鞘胺醇	鞘氨醇
鞘腹姬蛛属	鞘腹蛛属
韧体	固件
音效卡	声卡
音讯	音频
音讯档	音频文件 音频文档 音频档
音讯设定档	情景模式
音讯轨	音频轨
音讯输入	音频输入
音讯输出	音频输出
音频档	音频文件 音频文档
页尾	页脚
页库存档	网页快照
页面快取档	网页快照
页首	页眉
预留位置	占位符
预览列印	打印预览
预设	默认
领先股	前导链
频宽	带宽
颗粒球	粒细胞
颗粒白血球	粒细胞
飞航模式	飞行模式
食欲素	食欲肽
食道	食管
首页	主页
香港针房藤	狮子尾
马克士威	麦克斯韦
马可夫	马尔可夫
马可尼可夫	马尔科夫尼科夫
马可尼可夫法则	马氏规则
驱动程式	驱动程序
驹井氏钝头蛇	阿里山钝头蛇
骇客	黑客
骈七苯	并七苯
骈五苯	并五苯
骈六苯	并六苯
骈四苯	并四苯
骈苯	并苯
高传真	高保真
高基	高尔基
高基氏体	高尔基体
高清多媒体介面	高清多媒体界面
高画质	高清
高画质多媒体介面	高清多媒体界面
高速缓冲记忆体	高速缓冲存储器
高阶程式语言	高级编程语言
高阶语言	高级语言
高音质	高清音质
高音质音讯	高清音频
魁蛤属	蚶属
魁蛤目	蚶目
魁蛤科	蚶科
魅夸克	粲夸克
魅数	粲数
鲍莱耳	博雷尔
鲣节虫	皮蠹
鳃蛤蟆蛛	鳃蛤莫蛛
鸦片	阿片
鸭子型别	鸭子类型
鹰翼魁蛤	舟蚶
麦芽醇	麦芽酚
麦赛尔森	梅塞尔森
麸胺	谷氨
麸胺酸	谷氨酸
麸草转胺酶	谷草转氨酶
麸醯胺酸	谷氨酰胺
麻疹德国麻疹疫苗	麻风疫苗
麻疹腮腺炎	麻腮
麻疹腮腺炎德国麻疹	麻腮风
麻疹腮腺炎德国麻疹混合	麻腮风三联
麻竹属	牡竹属
黄金葛	绿萝
黄颔蛇科	游蛇科
黎纳	李纳
黏康酸	粘康酸
黑条蝇虎属	金蝉蛛属
黑画面	黑屏
黑箱测试	黑盒测试
黑维塞	亥维赛
