㐷	傌
㐹	㑶 㐹
㐽	偑
㑇	㑳
㑈	倲
㑔	㑯
㑩	儸
㑺	儁
㓆	𠗣
㓥	劏
㓰	劃
㔉	劚
㖊	噚
㖞	喎
㘎	㘚
㚯	㜄
㛀	媰
㛟	𡞵
㛠	𡢃
㛣	㜏
㛤	孋
㛿	𡠹
㝦	寯
㟆	㠏
㟜	𡾱
㟥	嵾
㡎	幓
㤖	懧
㤘	㥮
㤭	憍
㤽	懤
㥪	慺
㦈	𢣏
㧏	掆
㧐	㩳
㧑	撝
㧛	擥
㧟	擓
㧰	擽
㨫	㩜
㭎	棡
㭏	椲
㭣	𣙎
㭤	樢
㭴	樫
㮠	𣞁
㱩	殰
㱮	殨
㲿	瀇
㳔	濧
㳕	灡
㳠	澾
㳡	濄
㳢	𣾷
㳽	瀰
㴋	潚
㶉	鸂
㶶	燶
㶽	煱
㷪	𤎱
㺍	獱
㻅	璯
㻏	𤫩
㻘	𤪺
㻪	㻽
㾡	𤷽
䀥	䁻
䁖	瞜
䂵	碽
䃅	磾
䅉	稏
䅟	穇
䅪	𥢢
䇚	𥵜
䇲	筴
䉤	籔
䌶	䊷
䌷	紬
䌸	縳
䌹	絅
䌺	䋙
䌻	䋚
䌼	綐
䌽	綵
䌾	䋻
䌿	䋹
䍀	繿
䍁	繸
䍠	䍦
䎬	䎱
䏝	膞
䐪	臇
䑽	𦪙
䓓	薵
䓕	薳
䓖	藭
䓨	罃
䖼	𧍕
䗖	螮
䘛	𧝞
䘞	𧜗
䙊	𧜵
䙌	䙡
䙓	襬
䛓	譼
䜣	訢
䜤	鿁
䜥	𧩙
䜧	䜀
䜩	讌
䝙	貙
䞌	𧵳
䞍	䝼
䞎	𧶧
䞐	賰
䟢	躎
䢀	𨊰
䢁	𨊸
䢂	𨋢
䥺	釾
䥽	鏺
䥾	䥱
䥿	𨯅
䦀	𨦫
䦁	𨧜
䦂	䥇
䦃	鐯
䦅	鐥
䦆	钁
䦶	䦛
䦷	䦟
䩄	靦
䭪	𩞯
䯃	𩣑
䯄	騧
䯅	䯀
䲝	䱽
䲞	𩶘
䲟	鮣
䲠	鰆
䲡	鰌
䲢	鰧
䲣	䱷
䲤	鿐
䴓	鳾
䴔	鵁
䴕	鴷
䴖	鶄
䴗	鶪
䴘	鷉
䴙	鸊
䶮	龑
万	萬 万
与	與
丑	醜 丑
专	專
业	業
丛	叢
东	東
丝	絲
丢	丟
两	兩
严	嚴
丧	喪
个	個 箇
丰	豐 丰
临	臨
为	爲
丽	麗
举	舉
么	麼
义	義
乌	烏
乐	樂
乔	喬
习	習
乡	鄉
书	書
买	買
乱	亂
了	了 瞭
争	爭
于	於 于
亏	虧
云	雲 云
亘	亙 亘
亚	亞
产	產
亩	畝
亲	親
亵	褻
亸	嚲
亿	億
仅	僅
仆	僕 仆
仇	仇 讎
从	從
仑	侖 崙
仓	倉
仪	儀
们	們
价	價 价
仿	仿 彷
众	衆
优	優
伙	夥 伙
会	會
伛	傴
伞	傘
伟	偉
传	傳
伡	俥
伣	俔
伤	傷
伥	倀
伦	倫
伧	傖
伪	僞
伫	佇
体	體
余	餘 余
佛	佛 彿
佣	傭 佣
佥	僉
侠	俠
侣	侶
侥	僥
侦	偵
侧	側
侨	僑
侩	儈
侪	儕
侬	儂
侭	儘
俊	俊 儁
俣	俁
俦	儔
俨	儼
俩	倆
俪	儷
俫	倈
俭	儉
修	修 脩
借	借 藉
债	債
倾	傾
偬	傯
偻	僂
偾	僨
偿	償
傤	儎
傥	儻
傧	儐
储	儲
傩	儺
僵	僵 殭
儿	兒
克	克 剋
兑	兌
兖	兗
党	黨 党
兰	蘭
关	關
兴	興
兹	茲
养	養
兽	獸
冁	囅
内	內
冈	岡
册	冊
写	寫
军	軍
农	農
冬	冬 鼕
冯	馮
冲	衝 沖
决	決
况	況
冻	凍
净	淨
凄	悽 淒
准	準 准
凉	涼
凌	凌 淩
减	減
凑	湊
凛	凜
几	幾 几 機
凤	鳳
凫	鳧
凭	憑
凯	凱
凶	兇 凶
出	出 齣
击	擊
凿	鑿
刍	芻
划	劃 划
刘	劉
则	則
刚	剛
创	創
删	刪
别	別 彆
刬	剗
刭	剄
刮	刮 颳
制	制 製
刹	剎
刽	劊
刾	㓨
刿	劌
剀	剴
剂	劑
剐	剮
剑	劍
剥	剝
剧	劇
劝	勸
办	辦
务	務
劢	勱
动	動
励	勵
劲	勁
劳	勞
势	勢
勋	勳 勛
勚	勩
匀	勻
匦	匭
匮	匱
区	區
医	醫
千	千 韆
升	升 昇
华	華
协	協
单	單
卖	賣
卜	卜 蔔
占	佔 占
卢	盧
卤	滷 鹵
卧	臥
卫	衛
却	卻
卷	卷 捲
卺	巹
厂	廠 厂
厅	廳
历	歷 曆
厉	厲
压	壓
厌	厭
厍	厙
厐	龎
厕	廁
厘	釐 厘
厢	廂
厣	厴
厦	廈
厨	廚
厩	廄
厮	廝
县	縣
叁	叄
参	參 蔘
叆	靉
叇	靆
双	雙
发	發 髮
变	變
叙	敘
叠	疊
只	只 隻 祇
台	臺 檯 颱 台
叶	葉 叶
号	號
叹	嘆 歎
叽	嘰
吁	籲 吁
吃	喫 吃
合	合 閤
吊	吊 弔
同	同 衕
后	後 后
向	向 嚮 曏
吓	嚇
吕	呂
吗	嗎
吣	唚
吨	噸
听	聽
启	啓
吴	吳
呐	吶
呒	嘸
呓	囈
呕	嘔
呖	嚦
呗	唄
员	員
呙	咼
呛	嗆
呜	嗚
周	周 週 賙
咏	詠
咙	嚨
咛	嚀
咝	噝
咤	吒
咨	諮 咨
咸	鹹 咸
咽	咽 嚥
哄	哄 鬨
响	響
哑	啞
哒	噠
哓	嘵
哔	嗶
哕	噦
哗	譁 嘩
哙	噲
哜	嚌
哝	噥
哟	喲
唇	脣
唛	嘜
唝	嗊
唠	嘮
唡	啢
唢	嗩
唤	喚
啧	嘖
啬	嗇
啭	囀
啮	齧 嚙
啯	嘓
啰	囉
啴	嘽
啸	嘯
喂	喂 餵
喷	噴
喽	嘍
喾	嚳
嗫	囁
嗳	噯
嘘	噓
嘤	嚶
嘱	囑
噜	嚕
噪	噪 譟
嚣	囂
回	回 迴
团	團 糰
园	園
困	困 睏
囱	囪
围	圍
囵	圇
国	國
图	圖
圆	圓
圣	聖
圹	壙
场	場
坏	壞
块	塊
坚	堅
坛	壇 罈
坜	壢
坝	壩
坞	塢
坟	墳
坠	墜
垄	壟
垅	壠
垆	壚
垒	壘
垦	墾
垩	堊
垫	墊
垭	埡
垯	墶
垱	壋
垲	塏
垴	堖
埘	塒
埙	壎 塤
埚	堝
堑	塹
堕	墮
塆	壪
墙	牆
壮	壯
声	聲
壳	殼
壶	壺
壸	壼
处	處
备	備
复	復 複 覆
够	夠
夫	夫 伕
头	頭
夸	誇 夸
夹	夾
夺	奪
奁	奩
奂	奐
奋	奮
奖	獎
奥	奧
奨	奬
奸	奸 姦
妆	妝
妇	婦
妈	媽
妩	嫵
妪	嫗
妫	嬀
姗	姍
姜	姜 薑
姹	奼
娄	婁
娅	婭
娆	嬈
娇	嬌
娈	孌
娘	娘 孃
娱	娛
娲	媧
娴	嫺 嫻
婳	嫿
婴	嬰
婵	嬋
婶	嬸
媪	媼
媭	嬃
嫒	嬡
嫔	嬪
嫱	嬙
嬷	嬤
孙	孫
学	學
孪	孿
宁	寧 甯
它	它 牠
宝	寶
实	實
宠	寵
审	審
宪	憲
宫	宮
家	家 傢
宽	寬
宾	賓
寝	寢
对	對
寻	尋
导	導
寿	壽
将	將
尔	爾
尘	塵
尝	嘗 嚐
尧	堯
尴	尷
尸	屍 尸
尽	盡 儘
局	局 侷
层	層
屃	屓
屉	屜
届	屆
属	屬
屡	屢
屦	屨
屿	嶼
岁	歲
岂	豈
岖	嶇
岗	崗
岘	峴
岙	嶴
岚	嵐
岛	島
岩	巖 岩
岭	嶺
岳	嶽 岳
岽	崬
岿	巋
峃	嶨
峄	嶧
峡	峽
峣	嶢
峤	嶠
峥	崢
峦	巒
峰	峯
崂	嶗
崃	崍
崄	嶮
崭	嶄
嵘	嶸
嵚	嶔
嵝	嶁
巅	巔
巨	巨 鉅
巩	鞏
巯	巰
币	幣
布	布 佈
帅	帥
师	師
帏	幃
帐	帳
帘	簾 帘
帜	幟
带	帶
帧	幀
席	席 蓆
帮	幫
帱	幬
帻	幘
帼	幗
幂	冪
幞	襆
干	幹 乾 干
并	並 併
幸	幸 倖
广	廣 广
庄	莊
庆	慶
床	牀
庐	廬
庑	廡
库	庫
应	應
庙	廟
庞	龐
废	廢
庵	庵 菴
庼	廎
廪	廩
开	開
异	異
弃	棄
弑	弒
张	張
弥	彌 瀰
弦	弦 絃
弪	弳
弯	彎
弹	彈
强	強
归	歸
当	當 噹
录	錄 彔
彟	彠
彦	彥
彨	彲
彩	彩 綵
彻	徹
征	徵 征
径	徑
徕	徠
御	御 禦
忆	憶
忏	懺
志	志 誌
忧	憂
念	念 唸
忾	愾
怀	懷
态	態
怂	慫
怃	憮
怄	慪
怅	悵
怆	愴
怜	憐
总	總
怼	懟
怿	懌
恋	戀
恒	恆
恤	恤 卹
恳	懇
恶	惡 噁
恸	慟
恹	懨
恺	愷
恻	惻
恼	惱
恽	惲
悦	悅
悫	愨
悬	懸
悭	慳
悮	悞
悯	憫
惊	驚
惧	懼
惨	慘
惩	懲
惫	憊
惬	愜
惭	慚
惮	憚
惯	慣
愈	愈 癒
愠	慍
愤	憤
愦	憒
愿	願 愿
慑	懾
慭	憖
懑	懣
懒	懶
懔	懍
戆	戇
戋	戔
戏	戲
戗	戧
战	戰
戚	戚 慼
戬	戩
戯	戱
户	戶
才	才 纔
扎	扎 紮
扑	撲
托	託 托
扣	扣 釦
执	執
扩	擴
扪	捫
扫	掃
扬	揚
扰	擾
折	折 摺
抚	撫
抛	拋
抟	摶
抠	摳
抡	掄
抢	搶
护	護
报	報
抬	擡
抵	抵 牴
担	擔
拐	拐 柺
拟	擬
拢	攏
拣	揀
拥	擁
拦	攔
拧	擰
拨	撥
择	擇
挂	掛 挂
挙	𢸁
挚	摯
挛	攣
挜	掗
挝	撾
挞	撻
挟	挾
挠	撓
挡	擋
挢	撟
挣	掙
挤	擠
挥	揮
挦	撏
挨	挨 捱
挽	挽 輓
捝	挩
捞	撈
损	損
捡	撿
换	換
捣	搗
据	據 据
掳	擄
掴	摑
掷	擲
掸	撣
掺	摻
掼	摜
揽	攬
揾	搵
揿	撳
搀	攙
搁	擱
搂	摟
搄	揯
搅	攪
搜	搜 蒐
携	攜
摄	攝
摅	攄
摆	擺 襬
摇	搖
摈	擯
摊	攤
撄	攖
撑	撐
撵	攆
撷	擷
撸	擼
撺	攛
擜	㩵
擞	擻
攒	攢
敌	敵
敚	敓
敛	斂
敩	斆
数	數
斋	齋
斓	斕
斗	鬥 斗
斩	斬
断	斷
无	無
旧	舊
时	時
旷	曠
旸	暘
昆	昆 崑
昙	曇
昵	暱
昼	晝
昽	曨
显	顯
晋	晉
晒	曬
晓	曉
晔	曄
晕	暈
晖	暉
暂	暫
暅	𣈶
暗	暗 闇
暧	曖
曲	曲 麴
术	術 朮
朱	朱 硃
朴	樸 朴
机	機
杀	殺
杂	雜
权	權
杆	杆 桿
杠	槓 杠
条	條
来	來
杨	楊
杩	榪
杯	杯 盃
杰	傑 杰
松	松 鬆
板	板 闆
极	極 极
构	構
枞	樅
枢	樞
枣	棗
枥	櫪
枧	梘
枨	棖
枪	槍
枫	楓
枭	梟
柜	櫃 柜
柠	檸
柽	檉
栀	梔
栅	柵
标	標
栈	棧
栉	櫛
栊	櫳
栋	棟
栌	櫨
栎	櫟
栏	欄
树	樹
栖	棲
栗	慄 栗
样	樣
核	核 覈
栾	欒
桠	椏
桡	橈
桢	楨
档	檔
桤	榿
桥	橋
桦	樺
桧	檜
桨	槳
桩	樁
桪	樳
梁	梁 樑
梦	夢
梼	檮
梾	棶
梿	槤
检	檢
棁	梲
棂	櫺 欞
椁	槨
椝	槼
椟	櫝
椠	槧
椢	槶
椤	欏
椫	樿
椭	橢
椮	槮
楼	樓
榄	欖
榅	榲
榇	櫬
榈	櫚
榉	櫸
榝	樧
槚	檟
槛	檻
槟	檳
槠	櫧
横	橫
樯	檣
樱	櫻
橥	櫫
橱	櫥
橹	櫓
橼	櫞
檩	檁
欢	歡
欤	歟
欧	歐
欲	欲 慾
歼	殲
殁	歿
殇	殤
残	殘
殒	殞
殓	殮
殚	殫
殡	殯
殴	毆
毁	毀 燬 譭
毂	轂
毕	畢
毙	斃
毡	氈
毵	毿
毶	毿 𣯶
氇	氌
气	氣
氢	氫
氩	氬
氲	氳
汇	匯 彙
汉	漢
汤	湯
汹	洶
沈	沈 瀋
沟	溝
没	沒
沣	灃
沤	漚
沥	瀝
沦	淪
沧	滄
沨	渢
沩	潙
沪	滬
泛	泛 氾 汎
泞	濘
注	注 註
泪	淚
泶	澩
泷	瀧
泸	瀘
泺	濼
泻	瀉
泼	潑
泽	澤
泾	涇
洁	潔
洒	灑
洼	窪
浃	浹
浅	淺
浆	漿
浇	澆
浈	湞
浉	溮
浊	濁
测	測
浍	澮
济	濟
浏	瀏
浐	滻
浑	渾
浒	滸
浓	濃
浔	潯
浕	濜
涂	塗 涂
涌	湧 涌
涚	涗
涛	濤
涝	澇
涞	淶
涟	漣
涠	潿
涡	渦
涢	溳
涣	渙
涤	滌
润	潤
涧	澗
涨	漲
涩	澀
淀	澱 淀
渊	淵
渌	淥
渍	漬
渎	瀆
渐	漸
渑	澠
渔	漁
渖	瀋
渗	滲
温	溫
游	遊 游
湾	灣
湿	溼
溁	濚
溃	潰
溅	濺
溆	漵
溇	漊
滗	潷
滚	滾
滞	滯
滟	灩 灧
滠	灄
满	滿
滢	瀅
滤	濾
滥	濫
滦	灤
滨	濱
滩	灘
滪	澦
漓	漓 灕
漤	灠
潆	瀠
潇	瀟
潋	瀲
潍	濰
潜	潛
潴	瀦
澛	瀂
澜	瀾
濑	瀨
濒	瀕
灏	灝
灭	滅
灯	燈
灵	靈
灶	竈
灾	災
灿	燦
炀	煬
炉	爐
炖	燉
炜	煒
炝	熗
点	點
炼	煉 鍊
炽	熾
烁	爍
烂	爛
烃	烴
烛	燭
烟	煙 菸
烦	煩
烧	燒
烨	燁
烩	燴
烫	燙
烬	燼
热	熱
焕	煥
焖	燜
焘	燾
煴	熅
熏	薰 燻
爱	愛
爷	爺
牍	牘
牦	犛
牵	牽
牺	犧
犊	犢
状	狀
犷	獷
犸	獁
犹	猶
狈	狽
狝	獮
狞	獰
独	獨
狭	狹
狮	獅
狯	獪
狰	猙
狱	獄
狲	猻
猃	獫
猎	獵
猕	獼
猡	玀
猪	豬
猫	貓
猬	蝟
献	獻
獭	獺
玑	璣
玙	璵
玚	瑒
玛	瑪
玮	瑋
环	環
现	現
玱	瑲
玺	璽
珐	琺
珑	瓏
珰	璫
珲	琿
琎	璡
琏	璉
琐	瑣
琼	瓊
瑶	瑤
瑷	璦
瑸	璸
璎	瓔
瓒	瓚
瓮	甕
瓯	甌
电	電
画	畫
畅	暢
畴	疇
疖	癤
疗	療
疟	瘧
疠	癘
疡	瘍
疬	癧
疭	瘲
疮	瘡
疯	瘋
疱	皰
疴	痾
症	症 癥
痈	癰
痉	痙
痒	癢
痖	瘂
痨	癆
痪	瘓
痫	癇
痴	癡
瘅	癉
瘆	瘮
瘗	瘞
瘘	瘻
瘪	癟
瘫	癱
瘾	癮
瘿	癭
癞	癩
癣	癬
癫	癲
皂	皁 皂
皑	皚
皱	皺
皲	皸
盏	盞
盐	鹽
监	監
盖	蓋
盗	盜
盘	盤
眍	瞘
眦	眥
眬	矓
睁	睜
睐	睞
睑	瞼
瞆	瞶
瞒	瞞
瞩	矚
矩	矩 榘
矫	矯
矶	磯
矾	礬
矿	礦
砀	碭
码	碼
砖	磚
砗	硨
砚	硯
砜	碸
砺	礪
砻	礱
砾	礫
础	礎
硁	硜
硕	碩
硖	硤
硗	磽
硙	磑
硚	礄
确	確 确
硵	磠
硷	礆
碍	礙
碛	磧
碜	磣
碱	鹼
礼	禮
祃	禡
祎	禕
祢	禰
祯	禎
祷	禱
祸	禍
禀	稟
禄	祿
禅	禪
离	離
私	私 俬
秃	禿
秆	稈
秋	秋 鞦
种	種 种
秘	祕
积	積
称	稱
秽	穢
秾	穠
稆	穭
税	稅
稣	穌
稳	穩
穑	穡
穞	穭
穷	窮
窃	竊
窍	竅
窎	窵
窑	窯
窜	竄
窝	窩
窥	窺
窦	竇
窭	窶
竖	豎
竞	競
笃	篤
笋	筍
笔	筆
笕	筧
笺	箋
笼	籠
笾	籩
筑	築 筑
筚	篳
筛	篩
筜	簹
筝	箏
筹	籌
筼	篔
签	籤 簽
筿	篠
简	簡
箓	籙
箦	簀
箧	篋
箨	籜
箩	籮
箪	簞
箫	簫
篑	簣
篓	簍
篮	籃
篯	籛
篱	籬
簖	籪
籁	籟
籴	糴
类	類
籼	秈
粜	糶
粝	糲
粤	粵
粪	糞
粮	糧
粽	糉
糁	糝
糇	餱
糍	餈
系	系 係 繫
紧	緊
絷	縶
緼	縕
縆	緪
纟	糹
纠	糾
纡	紆
红	紅
纣	紂
纤	纖 縴
纥	紇
约	約
级	級
纨	紈
纩	纊
纪	紀
纫	紉
纬	緯
纭	紜
纮	紘
纯	純
纰	紕
纱	紗
纲	綱
纳	納
纴	紝
纵	縱
纶	綸
纷	紛
纸	紙
纹	紋
纺	紡
纻	紵
纼	紖
纽	紐 鈕
纾	紓
线	線
绀	紺
绁	紲
绂	紱
练	練
组	組
绅	紳
细	細
织	織
终	終
绉	縐
绊	絆
绋	紼
绌	絀
绍	紹
绎	繹
经	經
绐	紿
绑	綁
绒	絨
结	結
绔	絝
绕	繞
绖	絰
绗	絎
绘	繪
给	給
绚	絢
绛	絳
络	絡
绝	絕
绞	絞
统	統
绠	綆
绡	綃
绢	絹
绣	繡
绤	綌
绥	綏
绦	絛
继	繼
绨	綈
绩	績
绪	緒
绫	綾
绬	緓
续	續
绮	綺
绯	緋
绰	綽
绱	鞝 緔
绲	緄
绳	繩
维	維
绵	綿
绶	綬
绷	繃 綳
绸	綢
绹	綯
绺	綹
绻	綣
综	綜
绽	綻
绾	綰
绿	綠
缀	綴
缁	緇
缂	緙
缃	緗
缄	緘
缅	緬
缆	纜
缇	緹
缈	緲
缉	緝
缊	縕
缋	繢
缌	緦
缍	綞
缎	緞
缏	緶
缐	線
缑	緱
缒	縋
缓	緩
缔	締
缕	縷
编	編
缗	緡
缘	緣
缙	縉
缚	縛
缛	縟
缜	縝
缝	縫
缞	縗
缟	縞
缠	纏
缡	縭
缢	縊
缣	縑
缤	繽
缥	縹
缦	縵
缧	縲
缨	纓
缩	縮
缪	繆
缫	繅
缬	纈
缭	繚
缮	繕
缯	繒
缰	繮
缱	繾
缲	繰
缳	繯
缴	繳
缵	纘
罂	罌
网	網
罗	羅
罚	罰
罢	罷
罴	羆
羁	羈
羟	羥
羡	羨
群	羣
翘	翹
翙	翽
翚	翬
耢	耮
耧	耬
耸	聳
耻	恥
聂	聶
聋	聾
职	職
聍	聹
联	聯
聩	聵
聪	聰
肃	肅
肠	腸
肤	膚
肮	骯
肴	餚
肾	腎
肿	腫
胀	脹
胁	脅
胄	胄 冑
胆	膽
背	背 揹
胜	勝 胜
胡	胡 鬍 衚
胧	朧
胨	腖
胪	臚
胫	脛
胶	膠
脉	脈
脍	膾
脏	髒 臟
脐	臍
脑	腦
脓	膿
脔	臠
脚	腳
脱	脫
脶	腡
脸	臉
腊	臘 腊
腌	醃 腌
腘	膕
腭	齶
腻	膩
腼	靦
腽	膃
腾	騰
膑	臏
膻	羶 膻
臜	臢
致	致 緻
舆	輿
舍	舍 捨
舣	艤
舰	艦
舱	艙
舻	艫
艰	艱
艳	豔 艷
艺	藝
节	節
芈	羋
芗	薌
芜	蕪
芦	蘆
芸	芸 蕓
苁	蓯
苇	葦
苈	藶
苋	莧
苌	萇
苍	蒼
苎	苧
苏	蘇 甦 囌
苔	苔 薹
苧	薴
苹	蘋 苹
范	範 范
茎	莖
茏	蘢
茑	蔦
茔	塋
茕	煢
茧	繭
荆	荊
荐	薦 荐
荙	薘
荚	莢
荛	蕘
荜	蓽
荝	萴
荞	蕎
荟	薈
荠	薺
荡	蕩 盪
荣	榮
荤	葷
荥	滎
荦	犖
荧	熒
荨	蕁
荩	藎
荪	蓀
荫	蔭 廕
荬	蕒
荭	葒
荮	葤
药	藥 葯
莅	蒞
莱	萊
莲	蓮
莳	蒔
莴	萵
莶	薟
获	獲 穫
莸	蕕
莹	瑩
莺	鶯
莼	蓴
萚	蘀
萝	蘿
萤	螢
营	營
萦	縈
萧	蕭
萨	薩
葱	蔥
蒀	蒕
蒇	蕆
蒉	蕢
蒋	蔣
蒌	蔞
蒏	醟
蒙	蒙 矇 濛 懞
蓝	藍
蓟	薊
蓠	蘺
蓣	蕷
蓥	鎣
蓦	驀
蔂	虆
蔑	蔑 衊
蔷	薔
蔹	蘞
蔺	藺
蔼	藹
蕰	薀
蕲	蘄
蕴	蘊
薮	藪
藓	蘚
藴	蘊
蘖	櫱
虏	虜
虑	慮
虚	虛
虫	蟲 虫
虬	虯
虮	蟣
虱	蝨
虽	雖
虾	蝦
虿	蠆
蚀	蝕
蚁	蟻
蚂	螞
蚃	蠁
蚕	蠶
蚝	蠔 蚝
蚬	蜆
蛊	蠱
蛎	蠣
蛏	蟶
蛮	蠻
蛰	蟄
蛱	蛺
蛲	蟯
蛳	螄
蛴	蠐
蜕	蛻
蜗	蝸
蜡	蠟 蜡
蝇	蠅
蝈	蟈
蝉	蟬
蝎	蠍
蝼	螻
蝾	蠑
螀	螿
螨	蟎
蟏	蠨
衅	釁
衔	銜
补	補
表	表 錶
衬	襯
衮	袞
袄	襖
袅	嫋 裊
袆	褘
袜	襪
袭	襲
袯	襏
装	裝
裆	襠
裈	褌
裢	褳
裣	襝
裤	褲
裥	襉 襇
褛	褸
褝	襌
褴	襤
襕	襴
见	見
观	觀
觃	覎
规	規
觅	覓
视	視
觇	覘
览	覽
觉	覺
觊	覬
觋	覡
觌	覿
觍	覥
觎	覦
觏	覯
觐	覲
觑	覷
觞	觴
触	觸
觯	觶
訚	誾
詟	讋
誉	譽
誊	謄
讠	訁
计	計
订	訂
讣	訃
认	認
讥	譏
讦	訐
讧	訌
讨	討
让	讓
讪	訕
讫	訖
讬	託
训	訓
议	議
讯	訊
记	記
讱	訒
讲	講
讳	諱
讴	謳
讵	詎
讶	訝
讷	訥
许	許
讹	訛
论	論
讻	訩
讼	訟
讽	諷
设	設
访	訪
诀	訣
证	證 証
诂	詁
诃	訶
评	評
诅	詛
识	識
诇	詗
诈	詐
诉	訴
诊	診
诋	詆
诌	謅
词	詞
诎	詘
诏	詔
诐	詖
译	譯
诒	詒
诓	誆
诔	誄
试	試
诖	詿
诗	詩
诘	詰
诙	詼
诚	誠
诛	誅
诜	詵
话	話
诞	誕
诟	詬
诠	詮
诡	詭
询	詢
诣	詣
诤	諍
该	該
详	詳
诧	詫
诨	諢
诩	詡
诪	譸
诫	誡
诬	誣
语	語
诮	誚
误	誤
诰	誥
诱	誘
诲	誨
诳	誑
说	說
诵	誦
诶	誒
请	請
诸	諸
诹	諏
诺	諾
读	讀
诼	諑
诽	誹
课	課
诿	諉
谀	諛
谁	誰
谂	諗
调	調
谄	諂
谅	諒
谆	諄
谇	誶
谈	談
谉	讅
谊	誼
谋	謀
谌	諶
谍	諜
谎	謊
谏	諫
谐	諧
谑	謔
谒	謁
谓	謂
谔	諤
谕	諭
谖	諼
谗	讒
谘	諮
谙	諳
谚	諺
谛	諦
谜	謎
谝	諞
谞	諝
谟	謨
谠	讜
谡	謖
谢	謝
谣	謠
谤	謗
谥	諡 謚
谦	謙
谧	謐
谨	謹
谩	謾
谪	謫
谫	譾
谬	謬
谭	譚
谮	譖
谯	譙
谰	讕
谱	譜
谲	譎
谳	讞
谴	譴
谵	譫
谶	讖
谷	谷 穀
豮	豶
贝	貝
贞	貞
负	負
贠	貟
贡	貢
财	財
责	責
贤	賢
败	敗
账	賬
货	貨
质	質
贩	販
贪	貪
贫	貧
贬	貶
购	購
贮	貯
贯	貫
贰	貳
贱	賤
贲	賁
贳	貰
贴	貼
贵	貴
贶	貺
贷	貸
贸	貿
费	費
贺	賀
贻	貽
贼	賊
贽	贄
贾	賈
贿	賄
赀	貲
赁	賃
赂	賂
赃	贓
资	資
赅	賅
赆	贐
赇	賕
赈	賑
赉	賚
赊	賒
赋	賦
赌	賭
赍	齎
赎	贖
赏	賞
赐	賜
赑	贔
赒	賙
赓	賡
赔	賠
赕	賧
赖	賴
赗	賵
赘	贅
赙	賻
赚	賺
赛	賽
赜	賾
赝	贗 贋
赞	贊 讚
赟	贇
赠	贈
赡	贍
赢	贏
赣	贛
赪	赬
赵	趙
赶	趕
趋	趨
趱	趲
趸	躉
跃	躍
跄	蹌
跞	躒
践	踐
跶	躂
跷	蹺
跸	蹕
跹	躚
跻	躋
踌	躊
踪	蹤
踬	躓
踯	躑
蹑	躡
蹒	蹣
蹰	躕
蹿	躥
躏	躪
躜	躦
躯	軀
輼	轀
车	車
轧	軋
轨	軌
轩	軒
轪	軑
轫	軔
转	轉
轭	軛
轮	輪
软	軟
轰	轟
轱	軲
轲	軻
轳	轤
轴	軸
轵	軹
轶	軼
轷	軤
轸	軫
轹	轢
轺	軺
轻	輕
轼	軾
载	載
轾	輊
轿	轎
辀	輈
辁	輇
辂	輅
较	較
辄	輒
辅	輔
辆	輛
辇	輦
辈	輩
辉	輝
辊	輥
辋	輞
辌	輬
辍	輟
辎	輜
辏	輳
辐	輻
辑	輯
辒	轀
输	輸
辔	轡
辕	轅
辖	轄
辗	輾
辘	轆
辙	轍
辚	轔
辞	辭
辟	闢 辟
辩	辯
辫	辮
边	邊
辽	遼
达	達
迁	遷
过	過
迈	邁
运	運
还	還
这	這
进	進
远	遠
违	違
连	連
迟	遲
迩	邇
迳	逕
迹	跡 蹟
适	適 适
选	選
逊	遜
递	遞
逦	邐
逻	邏
遗	遺
遥	遙
邓	鄧
邝	鄺
邬	鄔
邮	郵
邹	鄒
邺	鄴
邻	鄰
郁	鬱 郁
郏	郟
郐	鄶
郑	鄭
郓	鄆
郦	酈
郧	鄖
郸	鄲
酂	酇
酝	醞
酦	醱
酱	醬
酸	酸 痠
酽	釅
酾	釃
酿	釀
醖	醞
采	採 采 寀
释	釋
里	裏 里
鉴	鑑 鑒
銮	鑾
錾	鏨
钅	釒
钆	釓
钇	釔
针	針 鍼
钉	釘
钊	釗
钋	釙
钌	釕
钍	釷
钎	釺
钏	釧
钐	釤
钑	鈒
钒	釩
钓	釣
钔	鍆
钕	釹
钖	鍚
钗	釵
钘	鈃
钙	鈣
钚	鈈
钛	鈦
钜	鉅
钝	鈍
钞	鈔
钟	鍾 鐘 鈡
钠	鈉
钡	鋇
钢	鋼
钣	鈑
钤	鈐
钥	鑰 鈅
钦	欽
钧	鈞
钨	鎢
钩	鉤
钪	鈧
钫	鈁 鍅
钬	鈥
钭	鈄
钮	鈕
钯	鈀
钰	鈺
钱	錢
钲	鉦
钳	鉗
钴	鈷
钵	鉢
钶	鈳
钷	鉕
钸	鈽
钹	鈸
钺	鉞
钻	鑽 鉆
钼	鉬
钽	鉭
钾	鉀
钿	鈿
铀	鈾
铁	鐵
铂	鉑
铃	鈴
铄	鑠
铅	鉛
铆	鉚
铇	鉋
铈	鈰
铉	鉉
铊	鉈
铋	鉍
铌	鈮
铍	鈹
铎	鐸
铏	鉶
铐	銬
铑	銠
铒	鉺
铓	鋩
铔	錏
铕	銪
铖	鋮
铗	鋏
铘	鋣
铙	鐃
铚	銍
铛	鐺
铜	銅
铝	鋁
铞	銱
铟	銦
铠	鎧
铡	鍘
铢	銖
铣	銑
铤	鋌
铥	銩
铦	銛
铧	鏵
铨	銓
铩	鎩
铪	鉿
铫	銚
铬	鉻
铭	銘
铮	錚
铯	銫
铰	鉸
铱	銥
铲	鏟 剷
铳	銃
铴	鐋
铵	銨
银	銀
铷	銣
铸	鑄
铹	鐒
铺	鋪
铻	鋙
铼	錸
铽	鋱
链	鏈 鍊
铿	鏗
销	銷
锁	鎖
锂	鋰
锃	鋥
锄	鋤
锅	鍋
锆	鋯
锇	鋨
锈	鏽
锉	銼
锊	鋝
锋	鋒
锌	鋅
锍	鋶
锎	鐦
锏	鐧
锐	銳
锑	銻
锒	鋃
锓	鋟
锔	鋦
锕	錒
锖	錆
锗	鍺
锘	鍩
错	錯
锚	錨
锛	錛
锜	錡
锝	鍀
锞	錁
锟	錕
锠	錩
锡	錫
锢	錮
锣	鑼
锤	錘
锥	錐
锦	錦
锧	鑕
锨	鍁
锩	錈
锪	鍃
锫	錇 鉳
锬	錟
锭	錠
键	鍵
锯	鋸
锰	錳
锱	錙
锲	鍥
锳	鍈
锴	鍇
锵	鏘
锶	鍶
锷	鍔
锸	鍤
锹	鍬
锺	鍾
锻	鍛
锼	鎪
锽	鍠
锾	鍰
锿	鎄
镀	鍍
镁	鎂
镂	鏤
镃	鎡
镄	鐨
镅	鎇
镆	鏌
镇	鎮
镈	鎛
镉	鎘
镊	鑷
镋	钂 鎲
镌	鐫
镍	鎳
镎	鎿 錼
镏	鎦
镐	鎬
镑	鎊
镒	鎰
镓	鎵
镔	鑌
镕	鎔
镖	鏢
镗	鏜
镘	鏝
镙	鏍
镚	鏰
镛	鏞
镜	鏡
镝	鏑
镞	鏃
镟	鏇
镠	鏐
镡	鐔
镢	钁 鐝
镣	鐐
镤	鏷
镥	鑥
镦	鐓
镧	鑭
镨	鐠
镩	鑹
镪	鏹
镫	鐙
镬	鑊
镭	鐳
镮	鐶
镯	鐲
镰	鐮 鎌
镱	鐿
镲	鑔
镳	鑣
镴	鑞
镵	鑱
镶	鑲
长	長
门	門
闩	閂
闪	閃
闫	閆
闬	閈
闭	閉
问	問
闯	闖
闰	閏
闱	闈
闲	閒 閑
闳	閎
间	間
闵	閔
闶	閌
闷	悶
闸	閘
闹	鬧
闺	閨
闻	聞
闼	闥
闽	閩
闾	閭
闿	闓
阀	閥
阁	閣
阂	閡
阃	閫
阄	鬮
阅	閱
阆	閬
阇	闍
阈	閾
阉	閹
阊	閶
阋	鬩
阌	閿
阍	閽
阎	閻
阏	閼
阐	闡
阑	闌
阒	闃
阓	闠
阔	闊
阕	闋
阖	闔
阗	闐
阘	闒
阙	闕
阚	闞
阛	闤
队	隊
阳	陽
阴	陰
阵	陣
阶	階
际	際
陆	陸
陇	隴
陈	陳
陉	陘
陕	陝
陦	隯
陧	隉
陨	隕
险	險
随	隨
隐	隱
隶	隸
隽	雋
难	難
雇	僱
雏	雛
雕	雕 鵰
雠	讎
雳	靂
雾	霧
霁	霽
霉	黴
霡	霢
霭	靄
靓	靚
靔	靝
静	靜
面	面 麪
靥	靨
鞑	韃
鞒	鞽
鞯	韉
鞲	韝
韦	韋
韧	韌
韨	韍
韩	韓
韪	韙
韫	韞
韬	韜
韵	韻
页	頁
顶	頂
顷	頃
顸	頇
项	項
顺	順
须	須 鬚
顼	頊
顽	頑
顾	顧
顿	頓
颀	頎
颁	頒
颂	頌
颃	頏
预	預
颅	顱
领	領
颇	頗
颈	頸
颉	頡
颊	頰
颋	頲
颌	頜
颍	潁
颎	熲
颏	頦
颐	頤
频	頻
颒	頮
颓	頹
颔	頷
颕	頴
颖	穎
颗	顆
题	題
颙	顒
颚	顎
颛	顓
颜	顏
额	額
颞	顳
颟	顢
颠	顛
颡	顙
颢	顥
颣	纇
颤	顫
颥	顬
颦	顰
颧	顴
风	風
飏	颺
飐	颭
飑	颮
飒	颯
飓	颶
飔	颸
飕	颼
飖	颻
飗	飀
飘	飄
飙	飆
飚	飈
飞	飛
飨	饗
餍	饜
饣	飠
饤	飣
饥	飢 饑
饦	飥
饧	餳
饨	飩
饩	餼
饪	飪
饫	飫
饬	飭
饭	飯
饮	飲
饯	餞
饰	飾
饱	飽
饲	飼
饳	飿
饴	飴
饵	餌
饶	饒
饷	餉
饸	餄
饹	餎
饺	餃
饻	餏
饼	餅
饽	餑
饾	餖
饿	餓
馀	餘
馁	餒
馂	餕
馃	餜
馄	餛
馅	餡
馆	館
馇	餷
馈	饋
馉	餶
馊	餿
馋	饞
馌	饁
馍	饃
馎	餺
馏	餾
馐	饈
馑	饉
馒	饅
馓	饊
馔	饌
馕	饢
马	馬
驭	馭
驮	馱
驯	馴
驰	馳
驱	驅
驲	馹
驳	駁
驴	驢
驵	駔
驶	駛
驷	駟
驸	駙
驹	駒
驺	騶
驻	駐
驼	駝
驽	駑
驾	駕
驿	驛
骀	駘
骁	驍
骂	罵
骃	駰
骄	驕
骅	驊
骆	駱
骇	駭
骈	駢
骉	驫
骊	驪
骋	騁
验	驗
骍	騂
骎	駸
骏	駿
骐	騏
骑	騎
骒	騍
骓	騅
骔	騌
骕	驌
骖	驂
骗	騙
骘	騭
骙	騤
骚	騷
骛	騖
骜	驁
骝	騮
骞	騫
骟	騸
骠	驃
骡	騾
骢	驄
骣	驏
骤	驟
骥	驥
骦	驦
骧	驤
髅	髏
髋	髖
髌	髕
鬓	鬢
鬶	鬹
魇	魘
魉	魎
鱼	魚
鱽	魛
鱾	魢
鱿	魷
鲀	魨
鲁	魯
鲂	魴
鲃	䰾
鲄	魺
鲅	鮁
鲆	鮃
鲇	鮎
鲈	鱸
鲉	鮋
鲊	鮓
鲋	鮒
鲌	鮊
鲍	鮑
鲎	鱟
鲏	鮍
鲐	鮐
鲑	鮭
鲒	鮚
鲓	鮳
鲔	鮪
鲕	鮞
鲖	鮦
鲗	鰂
鲘	鮜
鲙	鱠
鲚	鱭
鲛	鮫
鲜	鮮
鲝	鮺
鲞	鯗
鲟	鱘
鲠	鯁
鲡	鱺
鲢	鰱
鲣	鰹
鲤	鯉
鲥	鰣
鲦	鰷
鲧	鯀
鲨	鯊
鲩	鯇
鲪	鮶
鲫	鯽
鲬	鯒
鲭	鯖
鲮	鯪
鲯	鯕
鲰	鯫
鲱	鯡
鲲	鯤
鲳	鯧
鲴	鯝
鲵	鯢
鲶	鮎 鯰
鲷	鯛
鲸	鯨
鲹	鰺
鲺	鯴
鲻	鯔
鲼	鱝
鲽	鰈
鲾	鰏
鲿	鱨
鳀	鯷
鳁	鰮
鳂	鰃
鳃	鰓
鳄	鱷
鳅	鰍
鳆	鰒
鳇	鰉
鳈	鰁
鳉	鱂
鳊	鯿
鳋	鰠
鳌	鰲
鳍	鰭
鳎	鰨
鳏	鰥
鳐	鰩
鳑	鰟
鳒	鰜
鳓	鰳
鳔	鰾
鳕	鱈
鳖	鱉
鳗	鰻
鳘	鰵
鳙	鱅
鳚	䲁
鳛	鰼
鳜	鱖
鳝	鱔
鳞	鱗
鳟	鱒
鳠	鱯
鳡	鱤
鳢	鱧
鳣	鱣
鳤	䲘
鸟	鳥
鸠	鳩
鸡	雞
鸢	鳶
鸣	鳴
鸤	鳲
鸥	鷗
鸦	鴉
鸧	鶬
鸨	鴇
鸩	鴆
鸪	鴣
鸫	鶇
鸬	鸕
鸭	鴨
鸮	鴞
鸯	鴦
鸰	鴒
鸱	鴟
鸲	鴝
鸳	鴛
鸴	鷽
鸵	鴕
鸶	鷥
鸷	鷙
鸸	鴯
鸹	鴰
鸺	鵂
鸻	鴴
鸼	鵃
鸽	鴿
鸾	鸞
鸿	鴻
鹀	鵐
鹁	鵓
鹂	鸝
鹃	鵑
鹄	鵠
鹅	鵝
鹆	鵒
鹇	鷳 鷴
鹈	鵜
鹉	鵡
鹊	鵲
鹋	鶓
鹌	鵪
鹍	鵾
鹎	鵯
鹏	鵬
鹐	鵮
鹑	鶉
鹒	鶊
鹓	鵷
鹔	鷫
鹕	鶘
鹖	鶡
鹗	鶚
鹘	鶻
鹙	鶖
鹚	鷀
鹛	鶥
鹜	鶩
鹝	鷊
鹞	鷂
鹟	鶲
鹠	鶹
鹡	鶺
鹢	鷁
鹣	鶼
鹤	鶴
鹥	鷖
鹦	鸚
鹧	鷓
鹨	鷚
鹩	鷯
鹪	鷦
鹫	鷲
鹬	鷸
鹭	鷺
鹮	䴉
鹯	鸇
鹰	鷹
鹱	鸌
鹲	鸏
鹳	鸛
鹴	鸘
鹾	鹺
麦	麥
麸	麩
麹	麴
麺	麵
麽	麼
黄	黃
黉	黌
黡	黶
黩	黷
黪	黲
黾	黽
鼋	黿
鼌	鼂
鼍	鼉
鼹	鼴
齐	齊
齑	齏
齿	齒
龀	齔
龁	齕
龂	齗
龃	齟
龄	齡
龅	齙
龆	齠
龇	齜
龈	齦
龉	齬
龊	齪
龋	齲
龌	齷
龙	龍
龚	龔
龛	龕
龟	龜
鿎	䃮
鿏	䥑
鿒	鿓
鿔	鎶
鿕	𱆥
鿭	鉨 鑈
𠀾	𠁞
𠂲	𬓡
𠃓	昜
𠆲	儣
𠆿	𠌥
𠇐	㒜
𠇹	俓
𠉂	㒓
𠉗	𠏢
𠋆	儭
𠚳	𠠎
𠛅	剾
𠛆	𠞆
𠛾	𪟖
𠡠	勑
𠬤	睪
𠮶	嗰
𠯟	哯
𠯠	噅
𠰱	㘉
𠰷	嚧
𠱞	囃 𫝜
𠲥	𡅏
𠳞	𠶸
𠴛	𡃕
𠴢	𡄔
𠵸	𡄣
𠵾	㗲
𡈛	㘤
𡊑	壐
𡋀	𡓾
𡋗	𡑭
𡋤	壗
𡍣	𡔖
𡏆	𡒶
𡒄	壈
𡝠	㜷
𡞋	㜗
𡞱	㜢
𡠟	孎
𡡇	𡣨
𡥧	孻
𡭜	𡮉
𡭬	𡮣
𡳃	𡳳
𡳒	𦘧
𡵝	嵸
𡶴	嵼
𡸃	𡽗
𡺃	嶈
𡺄	嶘
𡻘	𭗡
𢀖	巠
𢋈	㢝
𢓅	𢕩
𢗓	㦛
𢘙	𢤱
𢘝	𢣚
𢘞	𢣭
𢙏	愻
𢙐	憹
𢙑	𢠼
𢙒	憢
𢙓	懀
𢛯	㦎
𢟼	懜
𢠁	懎
𢢐	𤢻
𢧐	戰
𢪓	擧
𢪗	𢷏
𢫊	𢷮
𢫘	攎
𢫞	𢶫
𢫬	摋
𢬍	擫
𢬦	𢹿
𢭏	擣
𢶣	㩹
𢽾	斅
𣃁	斸
𣆐	曥
𣈣	𣋋
𣉼	𣋞
𣍨	𦢈
𣍯	腪
𣍰	脥
𣎑	臗
𣏢	槫
𣐕	桱
𣐤	欍
𣑝	檲
𣑶	𣠲
𣒌	楇
𣒗	㮝
𣓿	橯
𣔌	樤
𣕲	㮓
𣗊	樠
𣗋	欓
𣗙	㰙
𣘐	㯤
𣘓	𣞻
𣘴	檭
𣘷	𣝕
𣘾	𬛕
𣙥	㯼
𣚚	欘
𣞎	𣠩
𣨼	殢
𣭤	𣯴
𣯣	𣯩
𣱝	氭
𣲗	湋
𣲘	潕
𣳆	㵗
𣶩	澅
𣶫	𣿉
𣶭	𪷓
𣷷	𤅶
𣸣	濆
𣺼	灙
𣺽	𤁣
𣽷	瀃
𣾍	㶌
𤆡	熓
𤆢	㷍
𤇃	爄
𤇄	熌
𤇭	爖
𤇹	熚
𤇻	𭶙
𤈶	熉
𤈷	㷿
𤊀	𤒎
𤊰	𤓩
𤋏	熡
𤎺	𤓎
𤎻	𤑳
𤙯	𤛮
𤜵	𤡲
𤝢	𤢟
𤞃	獩
𤞤	玁
𤠋	㺏
𤦀	瓕
𤩽	瓛
𤳄	𤳸
𤶊	癐
𤶧	𤸫
𤹺	𤻜
𤻊	㿗
𤽯	㿧
𤾀	皟
𤿲	麬
𥁢	䀉
𥅘	𥌃
𥅴	䀹
𥅿	𥊝
𥆧	瞤
𥇢	䁪
𥎝	䂎
𥐟	礒
𥐯	𥖅
𥐰	𥕥
𥐻	碙
𥕤	礚
𥞦	𥞵
𥟂	䅘
𥧂	𥨐
𥩟	竚
𥩺	𥪂
𥫣	籅
𥬀	䉙
𥬈	篵
𥬞	籋
𥬠	篘
𥭉	𥵊
𥮋	𥸠
𥮜	䉲
𥮾	篸
𥱔	𥵃
𥹥	𥼽
𥺅	䊭
𥺇	𥽖
𦈈	𥿊
𦈉	緷
𦈋	綇
𦈌	綀
𦈎	繟
𦈏	緍
𦈐	縺
𦈑	緸
𦈒	𦂅
𦈓	䋿
𦈔	縎
𦈕	緰
𦈖	䌈
𦈗	𦃄
𦈘	䌋
𦈙	䌰
𦈚	縬
𦈛	繓
𦈜	䌖
𦈝	繏
𦈞	䌟
𦈟	䌝
𦈠	䌥
𦈡	繻
𦍠	䍽
𦛨	朥
𦝼	膢
𦞌	𣎄
𦟗	𦣎
𦨩	𦪽
𦬙	𦿍
𦰏	蓧
𦰴	䕳
𦴇	𦾵
𦶟	爇
𦶻	𦾟
𦻕	蘟
𧈴	𫋧
𧈿	𬠐
𧉐	𧕟
𧉞	䗿
𧌥	𧎈
𧏖	蠙
𧏗	蠀
𧑏	蠾
𧒭	𧔥
𧜡	𧞔
𧜭	䙱
𧝝	襰
𧝧	𧟀
𧤤	觹
𧥅	觽
𧮪	詀
𧳕	𧳟
𧹑	䞈
𧹒	買
𧹓	𧶔
𧹔	賬
𧹕	䝻
𧹖	賟
𧹗	贃
𧺣	𧽵
𧿈	𨇁
𧿛	蹤
𨀁	躘
𨀱	𨄣
𨁴	𨅍
𨂺	𨈊
𨄄	𨈌
𨅛	䠱
𨅫	𨇞
𨅬	躝
𨉗	軉
𨐅	軗
𨐆	𨊻
𨐇	𨏠
𨐈	輄
𨐉	𨎮
𨐊	𨏥
𨑹	䢨
𨝕	𨞨
𨟳	𨣞
𨠨	𨣧
𨡙	𨢿
𨡺	𨣈
𨢸	𮡈
𨤰	𨤻
𨧮	䥸
𨰾	鎷
𨰿	釳
𨱀	𨥛
𨱁	鈠
𨱂	鈋
𨱃	鈲
𨱄	鈯
𨱅	鉁
𨱆	龯
𨱇	銶
𨱈	鋉
𨱉	鍄
𨱊	𨧱
𨱋	錂
𨱌	鏆
𨱍	鎯
𨱎	鍮
𨱏	鎝
𨱐	𨫒
𨱑	鐄
𨱒	鏉
𨱓	鐎
𨱔	鐏
𨱕	𨮂
𨱖	䥩
𨷿	䦳
𨸀	𨳕
𨸁	𨳑
𨸂	閍
𨸃	閐
𨸄	䦘
𨸅	𨴗
𨸆	𨵩
𨸇	𨵸
𨸉	𨶀
𨸊	𨶏
𨸋	𨶲
𨸌	𨶮
𨸎	𨷲
𨸘	𨽏
𨸟	䧢
𨻹	𨽈
𩏼	䪏
𩏽	𩏪
𩏾	𩎢
𩏿	䪘
𩐀	䪗
𩓋	顂
𩖕	𩓣
𩖖	顃
𩖗	䫴
𩙥	颰
𩙦	𩗀
𩙧	䬞 𩗡
𩙨	𩘹
𩙩	𩘀
𩙪	颷
𩙫	颾
𩙬	𩘺
𩙭	𩘝
𩙮	䬘
𩙯	䬝
𩙰	𩙈
𩟿	𩚛
𩠀	𩚥
𩠁	𩚵
𩠂	𩛆
𩠃	𩛩
𩠅	𩟐
𩠆	𩜦
𩠇	䭀
𩠈	䭃
𩠉	𩜇
𩠊	𩜵
𩠋	𩝔
𩠌	餸
𩠎	𩞄
𩠏	𩞦
𩠠	𩠴
𩡖	𩡣
𩡚	𩡤
𩧦	𩡺
𩧨	駎
𩧩	𩤊
𩧪	䮾
𩧫	駚
𩧬	𩢡
𩧭	䭿
𩧮	𩢾
𩧯	驋
𩧰	䮝
𩧱	𩥉
𩧲	駧
𩧳	𩢸
𩧴	駩
𩧵	𩢴
𩧶	𩣏
𩧸	𩣫
𩧺	駶
𩧻	𩣵
𩧼	𩣺
𩧿	䮠
𩨀	騔
𩨁	䮞
𩨂	驄
𩨃	騝
𩨄	騪
𩨅	𩤸
𩨆	𩤙
𩨇	䮫
𩨈	騟
𩨉	𩤲
𩨊	騚
𩨋	𩥄
𩨌	𩥑
𩨍	𩥇
𩨎	龭
𩨏	䮳
𩨐	𩧆
𩩈	䯤
𩬣	𩭙
𩬤	𩰀
𩬾	𩭯
𩭹	鬖
𩯒	𩯳
𩰰	𩰹
𩲒	𩳤
𩴌	𩴵
𩽹	魥
𩽺	𩵩
𩽻	𩵹
𩽼	鯶
𩽽	𩶱
𩽾	鮟
𩽿	𩶰
𩾁	鯄
𩾂	䲖
𩾃	鮸
𩾄	𩷰
𩾅	𩸃
𩾆	𩸦
𩾇	鯱
𩾈	䱙
𩾊	䱬
𩾋	䱰
𩾌	鱇
𩾎	𩽇
𪉂	䲰
𪉃	鳼
𪉄	𩿪
𪉅	𪀦
𪉆	鴲
𪉈	鴜
𪉉	𪁈
𪉊	鷨
𪉋	𪀾
𪉌	𪁖
𪉍	鵚
𪉎	𪂆
𪉏	𪃏
𪉐	𪃍
𪉑	鷔
𪉒	𪄕
𪉔	𪄆
𪉕	𪇳
𪎈	䴬
𪎉	麲
𪎊	麨
𪎋	䴴
𪎌	麳
𪑅	䵳
𪔭	𪔵
𪚏	𪘀
𪚐	𪘯
𪜎	𠿕
𪜺	𰂠
𪞝	凙
𪟎	㔋
𪟝	勣
𪟲	𫧝
𪠀	𧷎
𪠃	𫨑
𪠏	𥀬
𪠟	㓄
𪠡	𠬙
𪠳	唓
𪠵	㖮
𪠸	嚛
𪠺	𠽃
𪠽	噹
𪡀	嘺
𪡃	嘪
𪡋	噞
𪡏	嗹
𪡛	㗿
𪡞	嘳
𪡺	𡃄
𪢈	𢖕
𪢋	𰉀
𪢌	㘓
𪢐	𡃤
𪢒	𡂡
𪢕	嚽
𪢖	𡅯
𪢠	囒
𪢮	圞
𪢸	墲
𪣆	埬
𪣒	堚
𪣻	塿
𪤄	𡓁
𪤅	𰋆
𪤚	壣
𪥠	𧹈
𪥫	孇
𪥰	嬣
𪥿	嬻
𪧀	孾
𪧘	寠
𪨇	尵
𪨊	㞞
𪨗	屩
𪨧	崙
𪨩	𡸗
𪨶	輋
𪨷	巗
𪨹	𡹬
𪩇	㟺
𪩎	巊
𪩘	巘
𪩛	𡿖
𪩷	幝
𪩸	幩
𪪏	廬
𪪑	㢗
𪪞	廧
𪪴	𢍰
𪪼	彃
𪫌	徿
𪫡	𢤩
𪫷	㦞
𪫸	𢜭
𪫺	憸
𪬚	𢣐
𪬯	𢤿
𪭝	𢯷
𪭢	摐
𪭧	擟
𪭯	𢶒
𪭵	掚
𪭾	撊
𪮃	㨻
𪮋	㩋
𪮖	撧
𪮳	𢺳
𪮶	攋
𪯋	㪎
𪰶	曊
𪱥	膹
𪱷	梖
𪲎	櫅
𪲔	欐
𪲛	檵
𪲮	櫠
𪳍	欇
𪳗	𣜬
𪴙	欑
𪴯	歞
𪵇	𰚂
𪵑	毊
𪵣	霼
𪵱	濿
𪶄	溡
𪶒	𤄷
𪶮	𣽏
𪷍	㵾
𪷽	灒
𪸕	熂
𪸩	煇
𪹀	𤑹
𪹠	𤓌
𪹳	爥
𪹹	𤒻
𪺣	𤘀
𪺪	𤜆
𪺭	犞
𪺷	獊
𪺸	𤠮
𪺻	㺜
𪺽	猌
𪻐	瑽
𪻨	瓄
𪻲	瑻
𪻺	璝
𪼋	㻶
𪼴	𤬅
𪽂	𪌜
𪽈	畼
𪽝	𤳷
𪽪	痮
𪽭	𤷃
𪽮	㿖
𪽴	𤺔
𪽷	瘱
𪾔	盨
𪾢	睍
𪾣	眝
𪾦	矑
𪾸	矉
𪿊	𥏝
𪿞	𥖲
𪿫	礮
𪿵	𥗇
𫀌	𥜰
𫀓	𥜐
𫀨	䅐
𫀬	䅳
𫀮	𥢷
𫁂	䆉
𫁟	竱
𫁡	鴗
𫁱	𥶽
𫁲	䉑
𫁳	𥯤
𫁷	䉶
𫁺	𥴼
𫂃	簢
𫂆	簂
𫂈	䉬
𫂖	𥴨
𫂿	𥻦
𫃗	𩏷
𫄙	糺
𫄚	䊺
𫄛	紟
𫄜	䋃
𫄝	𥾯
𫄞	䋔
𫄟	絁
𫄠	絙
𫄡	絧
𫄢	絥
𫄣	繷
𫄤	繨
𫄥	纚
𫄦	𦀖
𫄧	綖
𫄨	絺
𫄩	䋦
𫄪	𦅇
𫄫	綟
𫄬	緤
𫄭	緮
𫄮	䋼
𫄯	𦃩
𫄰	縍
𫄱	繬
𫄲	縸
𫄳	縰
𫄴	繂
𫄵	𦅈
𫄶	繈
𫄷	繶
𫄸	纁
𫄹	纗
𫅅	䍤
𫅗	羵
𫅥	𦒀
𫅭	䎙
𫅼	𦔖
𫆏	聻
𫆝	𦟼
𫆫	𦡝
𫇘	𦧺
𫇛	艣
𫇪	𦱌
𫇭	蔿
𫇴	蒭
𫇽	蕽
𫈉	蕳
𫈎	葝
𫈟	蔯
𫈵	蕝
𫉁	薆
𫉄	藷
𫊪	䗅
𫊮	蠦
𫊱	蠒
𫊸	蟜
𫊹	𧒯
𫊻	蟳
𫋇	蟂
𫋌	蟘
𫋲	䙔
𫋷	襗
𫋹	襓
𫋻	襘
𫌀	襀
𫌇	襵
𫌋	𧞫
𫌨	覼
𫌩	𰴏
𫌪	覛
𫌫	𧡴
𫌬	𧢄
𫌭	覹
𫌯	䚩
𫍏	𫍘
𫍐	𧭹
𫍙	訑
𫍚	訞
𫍛	訜
𫍜	詓
𫍝	諫
𫍞	𧦝
𫍟	𧦧
𫍠	䛄
𫍡	詑
𫍢	譊
𫍣	詷
𫍤	譑
𫍥	誂
𫍦	譨
𫍧	誺
𫍨	誫
𫍩	諣
𫍪	誋
𫍫	䛳
𫍬	誷
𫍭	𧩕
𫍮	誳
𫍯	諴
𫍰	諰
𫍱	諯
𫍲	謏
𫍳	諥
𫍴	謱
𫍵	謸
𫍶	𧩼
𫍷	謉
𫍸	謆
𫍹	謯
𫍺	𧫝
𫍻	譆
𫍼	𧬤
𫍽	譞
𫍾	𧭈
𫍿	譾
𫎆	豵
𫎌	貗
𫎦	贚
𫎧	䝭
𫎨	𧸘
𫎩	賝
𫎪	䞋
𫎫	贉
𫎬	贑
𫎭	䞓
𫎱	䟐
𫎳	䟆
𫎸	𧽯
𫎺	䟃
𫏃	䠆
𫏆	蹳
𫏋	蹻
𫏌	𨂐
𫏐	蹔
𫏑	𨇽
𫏕	𨆪
𫏞	𨇰
𫏨	𨇤
𫐄	軏
𫐅	軕
𫐆	轣
𫐇	軜
𫐈	軷
𫐉	軨
𫐊	軬
𫐋	𨎌
𫐌	軿
𫐍	𨌈
𫐎	輢
𫐏	輖
𫐐	輗
𫐑	輨
𫐒	輷
𫐓	輮
𫐔	𨍰
𫐕	轊
𫐖	轇
𫐗	轐
𫐘	轗
𫐙	轠
𫐷	遱
𫑘	鄟
𫑡	鄳
𫑷	醶
𫓥	釟
𫓦	釨
𫓧	鈇
𫓨	鈛
𫓩	鏦
𫓪	鈆
𫓫	𨥟
𫓬	鉔
𫓭	鉠
𫓮	𨪕
𫓯	銈
𫓰	銊
𫓱	鐈
𫓲	銁
𫓳	𨰋
𫓴	鉾
𫓵	鋠
𫓶	鋗
𫓷	𫒡
𫓸	錽
𫓹	錤
𫓺	鐪
𫓻	錜
𫓼	𨨛
𫓽	錝
𫓾	錥
𫓿	𨨢
𫔀	鍊
𫔁	鐼
𫔂	鍉
𫔃	𨰲
𫔄	鍒
𫔅	鎍
𫔆	䥯
𫔇	鎞
𫔈	鎙
𫔉	𨰃
𫔊	鏥
𫔋	䥗
𫔌	鏾
𫔍	鐇
𫔎	鐍
𫔏	𨬖
𫔐	𨭸
𫔑	𨭖
𫔒	𨮳
𫔓	𨯟
𫔔	鑴
𫔕	𨰥
𫔖	𨲳
𫔭	開
𫔮	閒
𫔯	閗
𫔰	閞
𫔱	𨷻
𫔲	𨴹
𫔴	閵
𫔵	䦯
𫔶	闑
𫔽	𨼳
𫕚	𩀨
𫕥	霣
𫕨	𩅙
𫖃	靧
𫖅	䪊
𫖇	鞾
𫖑	𩎖
𫖒	韠
𫖓	𩏂
𫖔	韛
𫖕	韝
𫖖	𩏠
𫖪	𩑔
𫖫	䪴
𫖬	䪾
𫖭	𩒎
𫖮	顗
𫖯	頫
𫖰	䫂
𫖱	䫀
𫖲	䫟
𫖳	頵
𫖴	𩔳
𫖵	𩓥
𫖶	顅
𫖷	𩔑
𫖸	願
𫖹	顣
𫖺	䫶
𫗇	䫻
𫗈	𩗓
𫗉	𩗴
𫗊	䬓
𫗋	飋
𫗚	𩟗
𫗞	飦
𫗟	䬧
𫗠	餦
𫗡	𩚩
𫗢	飵
𫗣	飶
𫗤	𩛌
𫗥	餫
𫗦	餔
𫗧	餗
𫗨	𩛡
𫗩	饠
𫗪	餧
𫗫	餬
𫗬	餪
𫗭	餵
𫗮	餭
𫗯	餱
𫗰	䭔
𫗱	䭑
𫗲	𬲛
𫗳	𩝽
𫗴	饘
𫗵	饟
𫘛	馯
𫘜	馼
𫘝	駃
𫘞	駞
𫘟	駊
𫘠	駤
𫘡	駫
𫘣	駻
𫘤	騃
𫘥	騉
𫘦	騊
𫘧	騄
𫘨	騠
𫘩	騜
𫘪	騵
𫘫	騴
𫘬	騱
𫘭	騻
𫘮	䮰
𫘯	驓
𫘰	驙
𫘱	驨
𫘽	鬠
𫙂	𩯁
𫚈	鱮
𫚉	魟
𫚊	鰑
𫚋	鱄
𫚌	魦
𫚍	魵
𫚎	𩶁
𫚏	䱁
𫚐	䱀
𫚑	鮅
𫚒	鮄
𫚓	鮤
𫚔	鮰
𫚕	鰤
𫚖	鮆
𫚗	鮯
𫚘	𩻮
𫚙	鯆
𫚚	鮿
𫚛	鮵
𫚜	䲅
𫚝	𩸄
𫚞	鯬
𫚟	𩸡
𫚠	䱧
𫚡	鯞
𫚢	鰋
𫚣	鯾
𫚤	鰦
𫚥	鰕
𫚦	鰫
𫚧	鰽
𫚨	𩻗
𫚩	𩻬
𫚪	鱊
𫚫	鱢
𫚬	𩼶
𫚭	鱲
𫛚	鳽
𫛛	鳷
𫛜	鴀
𫛝	鴅
𫛞	鴃
𫛟	鸗
𫛠	𩿤
𫛡	鴔
𫛢	鸋
𫛣	鴥
𫛤	鴐
𫛥	鵊
𫛦	鴮
𫛧	𪀖
𫛨	鵧
𫛩	鴳
𫛪	鴽
𫛫	鶰
𫛬	䳜
𫛭	鵟
𫛮	䳤
𫛯	鶭
𫛰	䳢
𫛱	鵫
𫛲	鵰
𫛳	鵩
𫛴	鷤
𫛵	鶌
𫛶	鶒
𫛷	鶦
𫛸	鶗
𫛹	𪃧
𫛺	䳧
𫛻	𪃒
𫛼	䳫
𫛽	鷅
𫛾	𪆷
𫜀	鷐
𫜁	鷩
𫜂	𪅂
𫜃	鷣
𫜄	鷷
𫜅	䴋
𫜊	𪉸
𫜑	麷
𫜒	䴱
𫜓	𪌭
𫜔	䴽
𫜕	𪍠
𫜙	䵴
𫜟	𪓰
𫜨	䶕
𫜩	齧
𫜪	齩
𫜫	𫜦
𫜬	齰
𫜭	齭
𫜮	齴
𫜯	𪙏
𫜰	齾
𫜲	龓
𫜳	䶲
𫝈	㑮
𫝋	𠐊
𫝡	𡓗
𫝦	㛝
𫝧	㜐
𫝨	媈
𫝩	嬦
𫝪	𡟫
𫝫	婡
𫝬	嬇
𫝭	孆
𫝮	孄
𫝵	嶹
𫞅	𦠅
𫞗	潣
𫞚	澬
𫞛	㶆
𫞝	灍
𫞠	爧
𫞡	爃
𫞢	𤛱
𫞣	㹽
𫞥	珼
𫞦	璾
𫞧	𤩂
𫞨	璼
𫞩	璊
𫞷	𥢶
𫟃	絍
𫟄	綋
𫟅	綡
𫟆	緟
𫟇	𦆲
𫟑	䖅
𫟕	䕤
𫟞	訨
𫟟	詊
𫟠	譂
𫟡	誴
𫟢	䜖
𫟤	䡐
𫟥	䡩
𫟦	䡵
𫟫	𨞺
𫟬	𨟊
𫟲	釚
𫟳	釲
𫟴	鈖
𫟵	鈗
𫟶	銏
𫟷	鉝
𫟸	鉽
𫟹	鉷
𫟺	䤤
𫟻	銂
𫟼	鐽
𫟽	𨧰
𫟾	𨩰
𫟿	鎈
𫠀	䥄
𫠁	鑉
𫠂	閝
𫠅	韚
𫠆	頍
𫠇	𩖰
𫠈	䫾
𫠊	䮄
𫠋	騼
𫠌	𩦠
𫠏	𩵦
𫠐	魽
𫠑	䱸
𫠒	鱆
𫠖	𩿅
𫠜	齯
𫡬	𠷏
𫡶	𩅾
𫢒	儱
𫢔	𠐽
𫢘	𠏮
𫢙	働
𫢜	𰂴
𫢟	𪝖
𫢨	𠎒
𫢪	僆
𫢬	僗
𫢭	儰
𫢲	𫣴
𫢸	僤
𫢹	𠑙
𫢺	傪
𫣉	儖
𫣊	僾
𫣛	𠑲
𫣫	𠐍
𫤸	㝟
𫤽	𠖫
𫥍	𠘥
𫥔	𫥝
𫥳	𠠝
𫥵	𠠏
𫥺	𠟪
𫥼	𠜲
𫥽	𫦙
𫦁	𠝿
𫦅	㔅
𫦉	𠞭
𫦋	𫦔
𫦌	㔃
𫦩	㔝
𫦰	𫦸
𫦳	㔢
𫧃	𣍐
𫧮	𪋿
𫧯	卨
𫧷	𥽽
𫧿	贕
𫨆	𠩘
𫩕	嚝
𫩖	𠵘
𫩚	𠵹
𫩛	㗰
𫩤	㗼
𫩥	嚿
𫩩	㗙
𫩫	嚈
𫩯	𠹛
𫩳	𠼮
𫩸	𪢥
𫩺	嚍
𫪀	㗻
𫪁	唻
𫪂	㘙
𫪃	囇
𫪄	𠼤
𫪅	𠺮
𫪑	𰈝
𫪘	𡂿
𫪚	𠼗
𫪧	嘄
𫪪	𡂒
𫪺	㗣
𫪽	𠾬
𫫇	噁
𫫏	𫬆
𫫦	嚪
𫫵	𡀿
𫫾	嚬
𫬐	㘔
𫬙	𧸫
𫬟	𡅥
𫭞	塼
𫭟	塸
𫭢	埨
𫭨	墢
𫭪	墝
𫭮	𡍫
𫭯	𡑎
𫭲	壧
𫭼	𡑍
𫮃	墠
𫮅	墋
𫮜	㙬
𫯒	𨑊
𫯥	奯
𫯶	奫
𫰂	奲
𫰍	媁
𫰛	娙
𫰠	㜭
𫰡	嬅
𫰢	嬒
𫰣	𡤠
𫰨	㜥
𫰰	嬐
𫰹	嫢
𫱕	㜮
𫱿	𡤫
𫲗	㜺
𫲸	寷
𫳃	㝞
𫴼	𡮤
𫵵	崵
𫵶	𡺨
𫵷	㠣
𫵸	𡷨
𫵹	𡽵
𫶄	𫶦
𫶅	㠁
𫶇	嵽
𫶊	𡽳
𫶕	巆
𫶲	𣫒
𫷅	㡓
𫷈	𢄼
𫷉	幰
𫷌	𢅡
𫷘	𠁔
𫷬	庲
𫷮	廕
𫷷	廞
𫷹	廔
𫷾	廮
𫸩	彄
𫹮	懙
𫹴	愇
𫹷	𢥠
𫹼	𢛔
𫹽	慯
𫺁	㤲
𫺂	悏
𫺆	㦊
𫺊	懠
𫺌	愩
𫺒	𢢀
𫺓	㦖
𫺘	憦
𫺪	懩
𫺫	𢤜
𫺷	戁
𫺹	𫻑
𫻁	㦦
𫻇	𢤌
𫼗	𢲫
𫼝	搊
𫼣	𢳂
𫼤	𢯩
𫼥	㨟
𫼧	撶
𫼫	𢲾
𫼮	擃
𫼱	摃
𫼲	𢯦
𫼵	𢲸
𫼶	𢱡
𫼽	𪮰
𫼾	𢲩
𫽀	㨥
𫽁	摙
𫽇	㩇
𫽊	㩭
𫽋	攞
𫽐	𢳚
𫽔	𢷃
𫽙	𢴦
𫽢	𰔺
𫽣	摪
𫽥	攑
𫽧	㩌
𫽫	𰔫
𫽮	攩
𫽲	𢶑
𫽳	𢴩
𫾁	𢸴
𫾃	𢸳
𫾉	㩣
𫾏	𫾡
𫾲	𣀷
𫾳	𣀘
𫿂	𢿓
𫿗	𣀻
𬀥	𣄸
𬀩	暐
𬀪	晛
𬀮	㬣
𬀱	暟
𬁑	𣌂
𬁘	𰖻
𬁳	𦟐
𬁵	膒
𬁸	𦞛
𬁺	𦜖
𬁽	䐣
𬂀	膶
𬂂	𦣇
𬂅	䐷
𬂉	賸
𬂠	橅
𬂩	梜
𬂮	榝
𬂰	檂
𬂱	𪳷
𬂻	𣛣
𬃀	槻
𬃊	櫍
𬃏	𪴥
𬃘	樲
𬃛	𬄝
𬃦	𣚙
𬃫	櫶
𬃮	𣙿
𬃲	䫐
𬃳	𣡶
𬄞	𣠕
𬄩	櫽
𬄬	𣡌
𬅢	㰰
𬅥	歄
𬅫	歕
𬆂	𬆉
𬆙	𣩕
𬆦	毄
𬆮	鷇
𬆾	覒
𬇃	𨪅
𬇄	𣰨
𬇇	㲲
𬇕	澫
𬇘	漙
𬇙	浿
𬇬	𤅙
𬇰	㵍
𬇹	漍
𬇼	𣻏
𬈁	潬
𬈏	𬉤
𬈕	㵒
𬈧	濇
𬈱	𤀪
𬈾	𤁪
𬉂	瀵
𬉇	㵤
𬉋	瀢
𬉠	灡
𬉼	熰
𬊂	煼
𬊈	燖
𬊉	燵
𬊍	燽
𬊎	熕
𬊖	燘
𬊗	𤍖
𬊜	𤓓
𬊤	燀
𬊦	覢
𬊵	爣
𬊶	爁
𬊺	燰
𬊾	㸐
𬋃	𤒦
𬋍	㸊
𬌝	犓
𬌠	𬌦
𬌮	獟
𬌴	𤣤
𬌵	𬍁
𬌷	㺑
𬍙	琖
𬍛	瓅
𬍡	璗
𬍤	璕
𬎆	㼆
𬎑	瓓
𬎧	㼻
𬎬	𤮦
𬏜	㾺
𬏟	㾵
𬏤	𤻲
𬏦	癈
𬏫	瘒
𬏮	瘑
𬏷	㿎
𬐠	𥂸
𬑆	睔
𬑇	𥇔
𬑍	𬑡
𬑏	䀴
𬑒	䁱
𬑓	瞱
𬑕	睴
𬑗	瞷
𬑙	𥌚
𬑧	矊
𬒄	𬒒
𬒆	礏
𬒇	𥗺
𬒈	礐
𬒊	𥖩
𬒍	磒
𬒎	䃘
𬒓	𥗴
𬒕	䃤
𬒗	𥗽
𬓠	穖
𬓫	龝
𬓱	𥢊
𬓸	䵘
𬓼	穨
𬔯	𥱸
𬔹	𥳊
𬕂	篢
𬕄	籭
𬕊	䉍
𬕛	䉐
𬕦	䉱
𬕬	𥵝
𬖃	籫
𬖑	粯
𬖖	𥻤
𬖘	𥼶
𬖞	𥻵
𬖟	𫃐
𬖠	㪹
𬖮	糮
𬖺	𥽭
𬘓	紃
𬘔	𥾝
𬘕	紌
𬘖	絸
𬘗	𰫛
𬘘	紞
𬘙	䋐
𬘚	𥿉
𬘛	紶
𬘜	䋎
𬘝	紾
𬘞	𦄋
𬘟	絤
𬘠	絠
𬘡	絪
𬘢	絖
𬘣	𬗏
𬘤	絽
𬘥	絟
𬘦	𥿯
𬘧	纃
𬘨	綕
𬘩	綎
𬘪	䌞
𬘫	綄
𬘬	綪
𬘭	綝
𬘮	䌐
𬘯	綧
𬘰	緛
𬘱	䌁
𬘲	䋾
𬘳	𦄼
𬘴	䋺
𬘵	緪
𬘶	緧
𬘷	縒
𬘸	𦂋
𬘹	𫄇
𬘺	縚
𬘻	縖
𬘼	𦃒
𬘽	𦃘
𬘾	𦄍
𬘿	𦄧
𬙀	𬗺
𬙁	䌪
𬙂	縯
𬙃	𦅋
𬙄	𰫳
𬙅	𦅷
𬙆	繙
𬙇	繎
𬙈	繗
𬙉	繵
𬙊	纆
𬙋	纕
𬙎	罏
𬙏	𬙔
𬙝	罼
𬙪	𦌾
𬙫	𦍆
𬙭	䍷
𬚄	䎘
𬛹	䑗
𬛼	轝
𬜔	𦪭
𬜥	葻
𬜧	蕟
𬜨	薉
𬜬	蔄
𬜯	䓣
𬜸	蘹
𬜺	𦶆
𬜾	藖
𬜿	蔮
𬝁	䔡
𬝃	𤎤
𬝊	𦸷
𬝋	蠞
𬝖	𦵕
𬝠	𦽒
𬝯	薲
𬝴	䕼
𬞋	𦾶
𬞕	蘭
𬞘	藬
𬞟	蘋
𬞣	𧂅
𬞫	蘫
𬟁	虉
𬟪	覤
𬟺	𧐱
𬟽	蝀
𬠃	𧏻
𬠅	蟷
𬠈	𫋐
𬠠	蠈
𬠱	𧖦
𬠷	𧕦
𬡇	褭
𬡍	𧜣
𬡎	𧛸
𬡒	裌
𬡓	褺
𬡔	𧜂
𬡕	𧜁
𬡠	𧟌
𬡦	𧞶
𬡱	𫌙
𬡷	襸
𬡻	䊲
𬢇	𧠈
𬢈	𧡍
𬢉	𧠥
𬢊	覗
𬢋	覜
𬢌	覟
𬢍	𧠵
𬢎	覩
𬢏	𧡪
𬢐	䚉
𬢑	䚆
𬢒	覭
𬢓	𧢍
𬢔	覴
𬢕	𧣴
𬢪	譸
𬢯	譻
𬢳	謲
𬣀	讆
𬣙	訏
𬣚	𧥣
𬣛	䚳
𬣜	䚽
𬣝	𧥺
𬣞	詝
𬣟	䚵
𬣠	詌
𬣡	諓
𬣢	𧦭
𬣣	註
𬣤	詃
𬣥	詜
𬣦	詏
𬣧	䛍
𬣨	𧧝
𬣩	詴
𬣪	𧬨
𬣫	𬣍
𬣬	䛛
𬣭	譡
𬣮	詺
𬣯	䛘
𬣰	詯
𬣱	詶
𬣲	諩
𬣳	詪
𬣴	𧮇
𬣵	𧬻
𬣶	𧨊
𬣷	誎
𬣸	䛞
𬣹	䛤
𬣺	𧧭
𬣻	誔
𬣼	誏
𬣽	謰
𬣾	諎
𬣿	䜎
𬤀	諕
𬤁	䛬
𬤂	𧨾
𬤃	𰴽
𬤄	謲
𬤅	𧩦
𬤆	謴
𬤇	諲
𬤈	𧫚
𬤉	䜋
𬤊	諟
𬤋	𧩪
𬤌	䛽
𬤍	諻
𬤎	諠
𬤏	𧩧
𬤐	謌
𬤑	䛿
𬤒	𧪞
𬤓	𧪡
𬤔	𧪪
𬤕	𧪦
𬤖	𧬪
𬤗	𬣘
𬤘	䜉
𬤙	謼
𬤚	𧮆
𬤛	讇
𬤜	𧬅
𬤝	譓
𬤞	𧬇
𬤟	䜍
𬤠	𧬌
𬤡	䜒
𬤢	譐
𬤣	譈
𬤤	譄
𬤥	譔
𬤦	讉
𬤧	𧬮
𬤨	譟
𬤩	譺
𬤪	䜚
𬤫	譹
𬤬	䜝
𬤭	譿
𬤮	讚
𬤯	𧮈
𬤰	讙
𬤱	𧮓
𬤷	𧰆
𬥄	䝕
𬥈	䫉
𬥳	賶
𬥴	𧵊
𬥵	䝯
𬥶	貱
𬥷	𧶄
𬥸	賗
𬥹	𧶟
𬥺	䞁
𬥻	䞂
𬥼	𧶲
𬥽	䞀
𬥾	𧸦
𬥿	𧸪
𬦀	𬥲
𬦅	䞶
𬦆	𧽢
𬦣	𨇗
𬦥	䟺
𬦧	踚
𬦩	𨃘
𬦫	𨆅
𬦯	𨁂
𬦴	𨆱
𬦵	𨄰
𬦹	𨃜
𬦻	躀
𬦾	𨈇
𬧀	蹡
𬧃	䠮
𬧑	𨇍
𬧔	𬧙
𬧚	𨈀
𬧛	𨈆
𬧢	䡁
𬧤	軂
𬧩	𨉹
𬨁	軞
𬨂	軝
𬨃	𨋁
𬨄	軮
𬨅	𨋚
𬨆	䡗
𬨇	輆
𬨈	輓
𬨉	䡘
𬨋	𨌄
𬨌	䡟
𬨍	輵
𬨎	輶
𬨏	𨍐
𬨐	𨍹
𬨑	䡦
𬨒	𨎩
𬨓	轈
𬨔	䡶
𬩎	𨘌
𬩽	鄩
𬩾	郲
𬪍	鄮
𬪧	醧
𬪨	醆
𬪩	醲
𬪫	𨣉
𬪯	𨤋
𬪺	𨤡
𬬇	𨰵
𬬧	釬
𬬨	釫
𬬩	釴
𬬪	釦
𬬫	鈚
𬬬	鍏
𬬭	錀
𬬮	鋹
𬬯	鈓
𬬰	鎗
𬬱	釿
𬬲	釽
𬬳	𨥦
𬬴	𨥜
𬬵	鈂
𬬶	𨬞
𬬷	鉐
𬬸	鉥
𬬹	鉮
𬬺	鉏
𬬻	鑪
𬬼	𨭥
𬬽	鈼
𬬾	鑏
𬬿	鉊
𬭀	鈶
𬭁	鉧
𬭂	𨥺
𬭃	銔
𬭅	銗
𬭆	䤪
𬭇	𨭗
𬭈	䤩
𬭉	鑇
𬭊	𨧀
𬭋	𫒞
𬭌	鋘
𬭍	銲
𬭎	鋐
𬭏	鐊
𬭐	𨧚
𬭑	𨧫
𬭓	錪
𬭔	鑡
𬭕	錭
𬭖	錋
𬭗	錗
𬭘	𨨝
𬭙	𨭐
𬭚	錞
𬭛	𨨏
𬭜	錑
𬭝	鏒
𬭞	𨨹
𬭟	𨨯
𬭠	𨩨
𬭡	鍣
𬭢	鐀
𬭣	䤼
𬭤	鍭
𬭥	鍯
𬭦	鎒
𬭨	鎚
𬭩	鎓
𬭪	鎋
𬭫	𨫀
𬭬	鏏
𬭭	鏚
𬭯	䥕
𬭰	鏔
𬭱	𨬂
𬭲	鏁
𬭳	𨭎
𬭴	䥛
𬭵	𨭌
𬭶	𨭆
𬭷	𨭃
𬭸	鏻
𬭹	𨮅
𬭺	𨭚
𬭻	䥞
𬭼	鐩
𬭽	鐴
𬭾	𨮰
𬭿	鑙
𬮀	𨯵
𬮁	鑮
𬮂	𨰷
𬮃	𨰭
𬮄	𨲭
𬮘	閄
𬮙	𨷈
𬮜	𨳨
𬮝	𬮇
𬮟	焛
𬮠	閜
𬮡	𨳿
𬮢	閧
𬮣	𨴑
𬮤	閤
𬮥	閦
𬮧	𨴤
𬮨	䦝
𬮩	𨵆
𬮪	閯
𬮬	𮤒
𬮭	闚
𬮮	𨵤
𬮯	𨵗
𬮰	𨵌
𬮱	闉
𬮲	闄
𬮳	闆
𬮴	闇
𬮵	𨵬
𬮸	𨶻
𬮹	𨶿
𬮺	䧞
𬮻	隖
𬮿	隑
𬯀	隮
𬯅	陿
𬯊	𬯘
𬯎	隤
𬰡	𩉙
𬰣	𩉍
𬰤	𩋰
𬰥	䩫
𬰱	𩎒
𬰲	𩘚
𬰳	䪓
𬰴	𩎠
𬰵	𩏌
𬰶	韢
𬰷	䪜
𬰸	𩏴
𬰺	𩑃
𬱓	頄
𬱔	𩑣
𬱕	𩑦
𬱖	頔
𬱗	頕
𬱘	𫖞
𬱙	頖
𬱚	𬱂
𬱛	𩔊
𬱜	頛
𬱝	𩒝
𬱞	𠽸
𬱟	頠
𬱠	頢
𬱡	𩒜
𬱢	顐
𬱣	䫈
𬱤	𩒲
𬱥	𩒼
𬱦	䫏
𬱧	𩓸
𬱨	𩓹
𬱩	𬱈
𬱪	顊
𬱫	顁
𬱬	䫩
𬱭	𩔈
𬱮	䫜
𬱯	䭭
𬱰	䫠
𬱱	𩕊
𬱲	𩕰
𬱳	龥
𬱵	颹
𬱷	䫼
𬱸	䬂
𬱺	𩖿
𬱼	颽
𬱽	颴
𬱾	𮨭
𬱿	䬎
𬲀	䬍
𬲅	飉
𬲆	𩘻
𬲕	䭕
𬲥	𩚅
𬲦	飤
𬲧	𱃢
𬲨	𱃡
𬲩	𩚚
𬲪	𩞆
𬲫	䬯
𬲬	𩞡
𬲭	飷
𬲮	䬫
𬲯	䬲
𬲰	𩞃
𬲱	𮨻
𬲲	䭢
𬲳	䭞
𬲴	𩛎
𬲵	𫗑
𬲶	䭣
𬲷	䬶
𬲸	𩟂
𬲹	𩛲
𬲺	𩛞
𬲻	䬾
𬲼	餣
𬲽	𱃪
𬲾	䭅
𬲿	𩜠
𬳀	䭇
𬳁	餚
𬳂	餟
𬳃	𩜰
𬳄	𫗕
𬳅	䭉
𬳆	餰
𬳇	𩝑
𬳈	𩝡
𬳉	𩝣
𬳊	饀
𬳋	䭒
𬳌	𩝠
𬳍	餹
𬳎	𬲚
𬳐	𩞉
𬳑	䭘
𬳒	𩞬
𬳓	𩟀
𬳔	𩟠
𬳙	𫗻
𬳟	馩
𬳳	颿
𬳴	駍
𬳵	駓
𬳶	駉
𬳷	𩢍
𬳸	䮸
𬳹	𩣔
𬳺	𩢲
𬳻	𩢼
𬳼	𩣋
𬳽	駪
𬳾	䮈
𬳿	駼
𬴀	駺
𬴁	䮗
𬴂	騑
𬴃	騞
𬴄	𩤵
𬴅	騯
𬴆	騹
𬴇	𩥲
𬴈	𩥼
𬴉	𩦚
𬴊	驎
𬴋	驖
𬴌	𩦺
𬴍	䮽
𬴎	𩧐
𬴏	䮿
𬴐	驩
𬴨	𩯆
𬴩	鬞
𬶀	魝
𬶁	魜
𬶂	𩵚
𬶃	𬵃
𬶄	魡
𬶅	𩶀
𬶆	䰷
𬶇	魪
𬶈	𩵺
𬶉	𩵱
𬶊	䱍
𬶋	鮈
𬶌	鮘
𬶍	鮀
𬶎	䲙
𬶏	鮠
𬶐	鮡
𬶑	𬵮
𬶒	𩷒
𬶓	䱓
𬶔	鯌
𬶕	鮷
𬶖	𩸆
𬶗	䲏
𬶙	𩸣
𬶚	𩸤
𬶛	鱓
𬶜	𩸬
𬶝	𩸩
𬶞	鰗
𬶟	鯻
𬶠	鰊
𬶡	𩹝
𬶢	鯹
𬶣	䱹
𬶤	䱱
𬶥	𱇋
𬶦	𩹊
𬶧	鰇
𬶨	鱀
𬶩	𩹽
𬶪	𩺝
𬶫	鱑
𬶬	鱋
𬶭	鰶
𬶮	鱚
𬶯	𩻧
𬶰	𩻰
𬶱	𩻱
𬶲	鱌
𬶳	𩽈
𬶴	䲕
𬶵	鱞
𬶶	𩼔
𬶷	𣤿
𬶸	𩽅
𬶹	𩽔
𬶺	鱹
𬶻	𩽷
𬷕	鵏
𬷻	𩾐
𬷼	鶂
𬷽	𩾒
𬷾	䲨
𬷿	𪅜
𬸀	鴍
𬸁	𩿺
𬸂	𪀉
𬸃	𩿱
𬸄	𪈗
𬸅	鶵
𬸆	䲼
𬸈	鵄
𬸉	𪀛
𬸊	鵀
𬸋	𪀻
𬸌	𪄅
𬸍	𪇘
𬸎	𪁐
𬸏	𪁜
𬸐	𪁱
𬸑	𪁑
𬸒	鶀
𬸓	𪂫
𬸔	𪁿
𬸕	鸎
𬸖	𪂈
𬸗	𪂩
𬸘	鶠
𬸙	𪃦
𬸚	鸑
𬸛	䳨
𬸜	鶣
𬸝	鶕
𬸞	鷜
𬸟	𪃮
𬸠	𪃿
𬸡	𪇖
𬸢	鷎
𬸣	鶱
𬸤	𪅃
𬸥	𪅖
𬸦	鷟
𬸧	鷰
𬸨	𪅾
𬸩	䴈
𬸪	鷭
𬸫	𪆃
𬸬	𪇄
𬸭	𪆰
𬸮	𪆴
𬸯	鷿
𬸰	鸖
𬸱	鸜
𬸵	𪉜
𬸶	𪉨
𬸷	𪉮
𬸸	𪉱
𬸹	𪉿
𬸾	麡
𬹅	䴭
𬹆	𬹂
𬹇	𪌰
𬹈	𪌯
𬹉	䴷
𬹊	𪍀
𬹋	𪌽
𬹌	𪌿
𬹍	𪍤
𬹎	𪍶
𬹕	𪑳
𬹖	𪒬
𬹗	𪑚
𬹘	𪒿
𬹣	鼄
𬹤	𪓽
𬹭	𪕣
𬹺	齖
𬹻	𪗝
𬹼	齘
𬹽	𪗜
𬹾	𪗳
𬹿	𪗪
𬺀	𪗭
𬺁	𪗻
𬺂	𩖁
𬺃	䶣
𬺄	𪗽
𬺅	𪙞
𬺆	𪘞
𬺇	𪘓
𬺈	齮
𬺉	䶦
𬺊	𪘩
𬺋	𪘧
𬺌	𪘲
𬺍	䶢
𬺎	齹
𬺏	𪙍
𬺐	𪙕
𬺑	𪙑
𬺒	𪙤
𬺓	齼
𬺔	齽
𬺕	䶪
𬺖	𪚅
𬺛	𪚔
𬺜	㰍
𬺝	𪚣
𬺟	𧢢
𬻮	𫯓
𬾖	㒣
𬾣	𠐮
𭄛	劗
𭇀	𠿿
𭇉	𫪛
𭇙	𡁚
𭇜	㗶
𭇡	𡁯
𭇯	嚠
𭇴	𠵔
𭈈	𠺖
𭈉	𡄖
𭈜	𡀠
𭈟	𠽈
𭈮	𡄤
𭉗	𪢍
𭉨	𠿘
𭉼	𡅧
𭊸	𡅘
𭎂	㙡
𭎜	壔
𭏦	壒
𭏸	壝
𭑸	𡢿
𭑹	𡤡
𭓀	𫲴
𭕆	𧴪
𭘓	幠
𭘚	𢅣
𭚦	彍
𭝋	㦭
𭝫	𡄩
𭞄	懓
𭠙	擈
𭠽	𰔠
𭡆	𪯂
𭡜	𢸙
𭡵	𢵣
𭢋	𢸔
𭢕	𢷞
𭢝	𢺎
𭣇	攧
𭣧	斁
𭤎	斄
𭤰	旟
𭥓	𣊯
𭧋	曭
𭩚	檥
𭩛	椚
𭩰	橃
𭪆	檛
𭫀	樻
𭫙	㰅
𭫝	𠐇
𭭈	㰳
𭰎	澢
𭰒	𣻑
𭰗	𣼊
𭰥	𤅩
𭱀	𪷈
𭱊	澒
𭲫	灟
𭴊	㷻
𭴳	𤏐
𭹜	㼈
𭻍	𤲢
𭻔	𤲓
𮀡	𥘃
𮀤	磱
𮀪	𥖏
𮀲	𥔂
𮅎	𥵛
𮆏	籣
𮇔	𥺼
𮇤	𥾂
𮉠	䊵
𮉡	纑
𮉢	紩
𮉣	䋏
𮉤	絓
𮉥	𦀎
𮉧	緉
𮉨	緺
𮉩	𫃥
𮉪	緅
𮉫	緌
𮉬	綷
𮉭	𫃷
𮉮	繀
𮉯	縩
𮌌	𦡧
𮎍	𫇠
𮏀	𫉍
𮏺	𧁿
𮐚	薠
𮐨	蘡
𮔂	䗻
𮔅	蝜
𮔊	蜽
𮖁	裲
𮖃	𧜶
𮖱	襭
𮙊	讔
𮙋	讟
𮛗	𨆉
𮜶	軇
𮝴	軱
𮝵	輀
𮝷	轒
𮝸	輴
𮝹	轘
𮝺	轕
𮠞	䤌
𮠳	醦
𮣲	釭
𮣳	鈜
𮣴	鋋
𮣵	錣
𮣶	鑢
𮤫	閅
𮤬	䦌
𮤭	𨳒
𮤮	𭑙
𮤯	𨳙
𮤲	閟
𮤳	𮤏
𮤶	𰿢
𮤷	𬮍
𮤸	𨶯
𮦅	𮦗
𮦚	𩇉
𮧴	韔
𮧵	韡
𮨴	檒
𮨵	飂
𮩛	饆
𮩜	餀
𮩝	餲
𮩞	饐
𮪡	駹
𮪢	駴
𮪣	騣
𮪤	騲
𮪥	驐
𮫂	鬡
𮬛	魣
𮬜	鮨
𮬝	鱥
𮬞	䱗
𮬟	䱛
𮬠	䱚
𮬡	䱻
𮬢	䱵
𮬣	䲗
𮬤	鱵
𮭡	䲸
𮭢	鴁
𮭤	鴓
𮭥	䳍
𮭦	𪁏
𮭨	鷃
𮭪	鷞
𮭰	䴚
𮮄	麪
𮮅	𪌒
𮮇	麰
𮯙	䶗
𰁈	𭨡
𰁧	傱
𰁸	儅
𰁾	偩
𰂁	𪝵
𰂃	𠎅
𰂋	僴
𰂎	僩
𰂏	儥
𰂗	僀
𰂜	僓
𰂦	儢
𰂭	儩
𰂻	𠑇
𰃆	儹
𰃳	𰃴
𰃶	𭂖
𰃷	凔
𰃻	㓖
𰃿	凟
𰄁	𠗿
𰄞	剸
𰄭	𠠫
𰅔	勴
𰅥	匵
𰅦	匰
𰅻	𦾏
𰆕	㕒
𰆙	𠩬
𰆚	厱
𰇀	㕢
𰇊	𭉾
𰇎	㖦
𰇕	唊
𰇖	㗢
𰇘	𠷌
𰇠	嗧
𰇡	𠶹
𰇣	嚱
𰇥	𫬱
𰇲	嗿
𰇼	嘇
𰈆	囕
𰈇	嚐
𰈊	嚸
𰈍	嚫
𰈓	嚂
𰈮	𡃈
𰈯	囐
𰈶	嚩
𰉁	㘖
𰉄	囋
𰉘	㙔
𰉙	堈
𰉚	垷
𰉣	墿
𰉥	埉
𰉩	墧
𰉪	墷
𰉱	𡑯
𰉽	㙾
𰊂	墆
𰊅	𡓦
𰊈	墏
𰊑	壏
𰊛	㙺
𰊟	㙢
𰊡	壛
𰊢	壍
𰋖	𡗆
𰋸	婸
𰋹	嫥
𰋽	嬮
𰋾	𡠚
𰌀	嫈
𰌂	媜
𰌆	㜞
𰌇	嫧
𰌉	𡢘
𰌙	嬾
𰌦	孲
𰌷	寪
𰎌	嵷
𰎎	巃
𰎏	崠
𰎐	㠠
𰎑	嶪
𰎔	嶤
𰎖	崱
𰎛	𡼾
𰎝	𡺠
𰎞	嶩
𰎠	巖
𰎢	𡼱
𰎦	𰎼
𰎫	嶽
𰎴	𪌨
𰎷	𡾆
𰎹	巚
𰏁	巑
𰏓	𢄓
𰏕	帴
𰏜	㡞
𰏟	幱
𰏲	𢉿
𰏶	廥
𰏼	廗
𰏽	𢊃
𰐚	𢐗
𰐾	懭
𰑁	慱
𰑄	惀
𰑅	𢠰
𰑔	慹
𰑕	懕
𰑙	懰
𰑟	慐
𰑥	憪
𰑧	慙
𰑪	憴
𰑫	㦬
𰑬	懫
𰑵	慸
𰑸	㥷
𰑿	戃
𰒆	慲
𰒒	懘
𰒖	𢤧
𰓄	掁
𰓆	摀
𰓔	㨛
𰓕	𢸸
𰓗	𢹥
𰓙	擪
𰓜	擳
𰓝	𢲐
𰓟	𢹼
𰓤	𭢒
𰓧	搎
𰓬	攦
𰓱	摼
𰓷	撋
𰓻	摫
𰓼	摲
𰔇	摕
𰔋	撌
𰔲	㩷
𰔶	𢹏
𰕁	攳
𰕅	敺
𰕈	敿
𰕐	𢿡
𰕭	旝
𰖈	曮
𰖏	𭧒
𰖚	𭧖
𰖠	㬮
𰖩	㒿
𰗅	𦡏
𰗆	𦡖
𰗓	櫎
𰗖	棆
𰗘	𣔿
𰗙	㮲
𰗚	𣞐
𰗛	檡
𰗜	檿
𰗡	㯆
𰗢	楎
𰗦	㯸
𰗨	榯
𰗬	櫏
𰗵	㰂
𰗹	橚
𰗺	橨
𰘀	㯂
𰘅	𰘯
𰘈	檋
𰘓	檾
𰘠	櫩
𰘣	檰
𰘩	櫹
𰘳	櫴
𰘶	櫯
𰘸	櫢
𰙋	歍
𰙎	歛
𰙑	歗
𰙕	𣤋
𰚍	𰚣
𰚔	㲰
𰚦	氀
𰚪	㲯
𰚬	𪵢
𰚱	𣰛
𰛉	𣶯
𰛊	溤
𰛏	漎
𰛒	涷
𰛛	㴸
𰛡	滭
𰛣	漐
𰛤	瀄
𰛥	溰
𰛦	濊
𰛨	𭱘
𰛩	㶒
𰛪	灓
𰛮	滷
𰛱	𰝢
𰛲	澰
𰛵	澖
𰛺	𣼩
𰛻	𤅷
𰛽	㴿
𰜐	灠
𰜜	瀙
𰜝	瀁
𰜢	㵑
𰜨	瀳
𰜳	瀴
𰝅	瀯
𰝋	㶏
𰝍	瀈
𰝗	㶕
𰝜	𣴇
𰝞	𤄙
𰝟	㶍
𰝤	灦
𰝾	㷃
𰞇	燡
𰞉	㷲
𰞍	㸅
𰞤	熞
𰞲	㷶
𰞳	龽
𰞷	𤍜
𰞻	燌
𰟄	𰟫
𰟘	爓
𰠛	牋
𰠫	犅
𰠲	牼
𰠴	㹓
𰠹	犤
𰡄	獹
𰡉	𰡓
𰡊	獢
𰡋	𤟤
𰡎	猍
𰡏	猧
𰡐	𤠔
𰡔	獑
𰡞	獖
𰡢	𤣎
𰡩	玂
𰡰	𤥭
𰡵	瓐
𰡻	瑙
𰡽	璹
𰢄	璛
𰢢	甒
𰢤	甖
𰢦	甊
𰣢	𬏲
𰣦	𤺉
𰣩	𤻝
𰣫	𤼈
𰣬	癠
𰣯	癎
𰣶	㿉
𰣼	癪
𰣽	癴
𰤓	𤾉
𰤕	皪
𰤨	㿹
𰤫	𥀲
𰤬	皾
𰤽	𥂫
𰥊	䀍
𰥒	瞛
𰥛	瞓
𰥞	䁝
𰥠	矕
𰥢	矖
𰥣	𥉸
𰥨	瞯
𰥪	瞡
𰥭	𥋝
𰥹	矘
𰦔	䂓
𰦜	矲
𰦦	礰
𰦨	䃣
𰦭	礲
𰦰	礋
𰦴	䃁
𰦷	䃕
𰦾	礹
𰦿	碢
𰧃	磵
𰧇	礥
𰧈	𥗹
𰧉	礩
𰧎	䃢
𰧔	礛
𰧘	䃴
𰧰	禓
𰧻	禬
𰧾	禯
𰨖	禵
𰨜	穬
𰨦	穧
𰨳	䆅
𰩅	竉
𰩏	窱
𰩓	竀
𰩧	䇓
𰩮	篿
𰩲	籚
𰩸	簥
𰩹	簜
𰩺	箹
𰩻	簻
𰪊	籦
𰪏	簵
𰪣	籯
𰪪	𰫆
𰪫	䊜
𰪭	粻
𰪶	糰
𰪼	𰫏
𰪿	𫃑
𰫋	䊟
𰫖	糷
𰫼	糽
𰫽	紑
𰫿	𫃞
𰬀	紒
𰬁	䋆
𰬂	䋍
𰬃	䋑
𰬅	紨
𰬆	絇
𰬇	紸
𰬈	絃
𰬉	紽
𰬋	紭
𰬌	絚
𰬍	綊
𰬎	縪
𰬏	絑
𰬐	繑
𰬑	䋫
𰬒	絘
𰬓	絯
𰬔	絣
𰬖	絾
𰬗	絿
𰬘	綍
𰬙	𦁄
𰬚	縜
𰬛	絼
𰬜	絻
𰬝	𦅘
𰬞	綅
𰬟	緎
𰬠	繣
𰬡	緁
𰬢	緀
𰬣	緆
𰬤	綼
𰬥	総
𰬦	𦁕
𰬧	緂
𰬨	𦁧
𰬩	繡
𰬪	縿
𰬫	緻
𰬬	緢
𰬭	䋽
𰬮	縴
𰬯	緵
𰬰	緫
𰬱	䌇
𰬲	縓
𰬳	縌
𰬴	縡
𰬵	縼
𰬶	䌌
𰬷	繖
𰬸	繐
𰬹	𦆈
𰬺	繜
𰬻	繘
𰬼	𦇛
𰬽	繲
𰬾	𦆆
𰬿	纀
𰭀	纋
𰭁	𦇎
𰭄	罆
𰭔	羂
𰭗	𦏑
𰭚	𦎹
𰭢	翜
𰭣	翿
𰭹	䏊
𰮅	膷
𰮇	膴
𰮙	䐢
𰮝	膮
𰮭	𣎜
𰮲	䐹
𰯂	𦡶
𰯋	臡
𰯎	䐽
𰰆	𦧴
𰰋	艭
𰰌	䑼
𰰏	艜
𰰑	艛
𰰠	藇
𰰢	𦳝
𰰤	蓲
𰰨	菕
𰰮	蘬
𰰱	薱
𰰳	蒒
𰰴	䔇
𰰵	蔱
𰰶	䕹
𰰷	萯
𰰹	藰
𰰺	蔎
𰰾	薖
𰰿	𫈹
𰱀	䔈
𰱇	蕑
𰱈	禜
𰱉	蕄
𰱊	𧃽
𰱌	蒳
𰱍	蒶
𰱐	藚
𰱑	蔪
𰱛	蔠
𰱝	𦺣
𰱟	蕡
𰱦	蕧
𰱩	䕡
𰱮	藘
𰱯	藣
𰱱	薋
𰱲	蘵
𰱾	藾
𰲁	蘈
𰲂	虅
𰲒	蘱
𰲖	䖀
𰲟	䖚
𰲠	虦
𰲫	蟱
𰲬	蛼
𰲮	蜸
𰲯	䗥
𰲰	蜦
𰲲	蟡
𰲳	䗃
𰲴	蠪
𰲵	蠌
𰲶	蛵
𰲸	蝁
𰲹	螘
𰲺	𧒖
𰲻	蟽
𰳁	𧐐
𰳂	螹
𰳄	螴
𰳆	𪘅
𰳊	蟦
𰳗	蠳
𰳚	䗽
𰳲	襱
𰳵	襼
𰳸	襨
𰳹	𧞣
𰳺	襛
𰳻	𧞅
𰳼	襹
𰴂	襂
𰴕	覕
𰴖	䙼
𰴗	䚕
𰴘	覸
𰴙	覠
𰴚	𧢃
𰴛	𧡸
𰴜	覰
𰴝	覶
𰴞	覻
𰴢	觻
𰴣	觷
𰴤	䚞
𰴥	𰴦
𰴯	謍
𰵊	訆
𰵌	諹
𰵍	訰
𰵎	訧
𰵏	訬
𰵐	䛀
𰵑	譌
𰵒	訦
𰵓	訹
𰵔	詍
𰵖	讛
𰵗	詇
𰵘	𧦦
𰵙	詄
𰵚	詅
𰵛	訽
𰵜	䛌
𰵝	訸
𰵞	詠
𰵠	詉
𰵡	誙
𰵢	𧧵
𰵣	詥
𰵤	詻
𰵥	誃
𰵦	詨
𰵧	誌
𰵨	讝
𰵩	誧
𰵪	𧨝
𰵫	䛠
𰵬	𧧸
𰵭	誗
𰵮	誐
𰵯	誜
𰵰	䛭
𰵱	諃
𰵲	諆
𰵳	𧨳
𰵴	諔
𰵵	誽
𰵶	諈
𰵷	諁
𰵸	誻
𰵹	讘
𰵺	謜
𰵻	𧪮
𰵼	謋
𰵽	謟
𰵾	謑
𰵿	謞
𰶀	謣
𰶁	謻
𰶂	謥
𰶃	謵
𰶄	譇
𰶅	𧬁
𰶆	譀
𰶇	䜏
𰶈	䜄
𰶉	譠
𰶊	譩
𰶋	𧬯
𰶌	譳
𰶍	讂
𰶎	譅
𰶏	讑
𰶑	豅
𰶔	豄
𰶨	𧱻
𰶬	䝏
𰷞	貣
𰷠	貤
𰷡	貦
𰷢	貾
𰷤	賥
𰷥	賨
𰷦	靅
𰷧	賮
𰷨	𧷛
𰷩	䞉
𰷪	賹
𰷫	贆
𰷬	𧸖
𰷭	贓
𰷮	贙
𰷴	䟏
𰷵	趬
𰷶	趫
𰷸	𧾥
𰸇	𨇯
𰸈	䠟
𰸊	䠩
𰸎	𨄉
𰸐	躧
𰸔	蹥
𰸚	蹛
𰸛	䠠
𰸞	蹪
𰸦	𮜗
𰹀	軃
𰹯	𰹈
𰹱	𨊠
𰹲	軎
𰹳	䡅
𰹴	軓
𰹵	轙
𰹶	軖
𰹷	䡇
𰹸	軘
𰹺	䡊
𰹻	𨊹
𰹼	輚
𰹽	軯
𰹾	𨍒
𰹿	軵
𰺀	軧
𰺁	軥
𰺂	軳
𰺃	轛
𰺄	輁
𰺅	輂
𰺆	𨋮
𰺇	輐
𰺈	輑
𰺉	輤
𰺊	輘
𰺋	輙
𰺌	𨏔
𰺍	輠
𰺎	輫
𰺏	輣
𰺐	輡
𰺑	䡝
𰺒	輲
𰺓	輹
𰺔	𨍈
𰺕	𨍏
𰺖	轃
𰺗	轞
𰺘	䡰
𰺙	轖
𰺚	𨎪
𰺛	轑
𰺜	轓
𰺝	䡴
𰺞	轏
𰺟	轚
𰺠	䡾
𰺡	䡷
𰺢	𨏒
𰺣	轥
𰺤	䡻
𰺨	𨐶
𰺭	䢈
𰺲	逿
𰺷	遶
𰻆	遰
𰻝	𰻞
𰻡	鄦
𰻦	鄬
𰻨	𮟽
𰻮	鄡
𰻳	鄪
𰼅	醳
𰼋	𨣃
𰼏	𨣨
𰼑	䤍
𰼻	鑋
𰽕	鐖
𰽖	釛
𰽗	釪
𰽘	釱
𰽚	鑛
𰽛	釥
𰽜	鏂
𰽝	䥶
𰽞	鈪
𰽠	䤠
𰽡	鈤
𰽢	鋧
𰽣	鈏
𰽥	鈵
𰽦	鑨
𰽧	鉟
𰽨	鉙
𰽩	鉲
𰽫	鉎
𰽬	鉌
𰽭	鉤
𰽮	鉜
𰽯	鉒
𰽰	鉡
𰽱	鉘
𰽲	銡
𰽳	顉
𰽴	銙
𰽵	銧
𰽶	鉵
𰽷	鐬
𰽸	䤨
𰽹	鉹
𰽺	䤥
𰽻	銋
𰽼	鉼
𰽽	𨦡
𰽾	鐹
𰽿	銸
𰾀	鋍
𰾁	銾
𰾃	鋜
𰾄	鋂
𰾅	鋡
𰾆	鋊
𰾇	𨧐
𰾈	䤬
𰾉	𫒢
𰾋	龲
𰾌	鏩
𰾍	錶
𰾎	錍
𰾏	鋾
𰾐	䤵
𰾑	鍂
𰾒	錧
𰾓	錔
𰾕	鍱
𰾖	䤻
𰾗	鍼
𰾘	鍖
𰾙	鍝
𰾚	鍡
𰾛	鎅
𰾜	鍴
𰾝	鍟
𰾞	鍐
𰾟	鍑
𰾡	鍧
𰾢	鍦
𰾣	𫒷
𰾤	鍜
𰾥	鍨
𰾦	䤸
𰾧	𨫼
𰾨	𨪋
𰾩	鎑
𰾪	鐚
𰾫	鑑
𰾬	鎉
𰾭	鑀
𰾮	鎌
𰾯	鎕
𰾰	鏙
𰾱	鏓
𰾲	鏕
𰾳	𨬒
𰾴	鐁
𰾵	𨬟
𰾶	鏸
𰾷	鐕
𰾸	鐤
𰾹	鐫
𰾺	𨮁
𰾻	䥖
𰾼	鐉
𰾽	钃
𰾾	钀
𰾿	𨭛
𰿀	𨰹
𰿁	䥝
𰿂	鑐
𰿃	鑖
𰿄	鑘
𰿅	䥴
𰿆	鑽
𰿇	䥷
𰿈	鑯
𰿉	鑸
𰿊	𨰠
𰿖	𨱥
𰿥	𫔘
𰿦	𨳌
𰿧	𨳐
𰿨	䦎
𰿩	閕
𰿪	𨳚
𰿫	䦱
𰿬	閛
𰿭	𨳸
𰿯	𫔡
𰿰	𨉖
𰿳	閷
𰿴	䦪
𰿵	𨵦
𰿸	𨶑
𰿹	𨶰
𰿺	闛
𰿻	闟
𰿾	闢
𱀑	隲
𱀡	隫
𱁒	䨴
𱁞	𩅦
𱁱	𩋌
𱁳	𩍜
𱁴	鞸
𱁶	韆
𱁷	韇
𱁹	鞼
𱁺	鞻
𱁽	䪍
𱁾	韊
𱂃	𩎕
𱂄	𩎟
𱂅	䪐
𱂆	韐
𱂇	韏
𱂈	韗
𱂉	韒
𱂊	韘
𱂋	韣
𱂌	䪝
𱂍	𩐌
𱂎	䪥
𱂐	韻
𱂠	𩑒
𱂡	𩑡
𱂢	䪼
𱂣	顤
𱂤	顪
𱂥	頟
𱂦	頩
𱂧	頪
𱂨	頞
𱂩	𩒺
𱂫	顩
𱂬	頯
𱂭	顀
𱂮	䫌
𱂯	顇
𱂰	顄
𱂱	顑
𱂲	顋
𱂳	𩔇
𱂴	顜
𱂵	顝
𱂶	顖
𱂷	𩔣
𱂸	顮
𱂺	顠
𱂻	顦
𱃔	颩
𱃕	颬
𱃖	䬀
𱃗	颱
𱃘	颲
𱃙	䬟
𱃚	䬅
𱃛	𩗛
𱃜	䬐
𱃝	飍
𱃞	䬔
𱃟	飁
𱃠	飇
𱃱	䬣
𱃲	饇
𱃳	䬪
𱃴	飰
𱃵	䬬
𱃷	䬳
𱃸	䬹
𱃹	䭓
𱃺	餂
𱃼	餴
𱃽	餩
𱃾	餢
𱃿	餤
𱄀	饙
𱄁	𩜶
𱄂	𩜯
𱄃	䭈
𱄄	餯
𱄅	𩝧
𱄆	饎
𱄇	𩞧
𱄈	饛
𱄉	䭡
𱄊	饡
𱄼	馵
𱄽	馲
𱄾	𩧉
𱄿	騳
𱅀	駂
𱅁	馽
𱅂	馺
𱅃	駏
𱅄	䮂
𱅅	驡
𱅇	駗
𱅈	駜
𱅉	駥
𱅊	騺
𱅋	駬
𱅍	𩣊
𱅎	𩢰
𱅏	駣
𱅐	駮
𱅒	𩧢
𱅓	𩣡
𱅔	駷
𱅕	騋
𱅖	駽
𱅗	騀
𱅘	𩦃
𱅙	駾
𱅚	騇
𱅛	驒
𱅜	騕
𱅝	騗
𱅞	騢
𱅟	騥
𱅠	䮧
𱅡	騩
𱅢	騬
𱅣	𩥅
𱅤	驞
𱅥	𩥃
𱅦	䮲
𱅧	驉
𱅨	𩥎
𱅩	騽
𱅪	驔
𱅫	驈
𱅬	驠
𱅮	髐
𱆀	鬝
𱆁	鬜
𱆃	䰎
𱆄	𩯃
𱆅	䰐
𱆆	鬗
𱆈	䰖
𱆌	鬺
𱆍	𩱈
𱆖	𩴆
𱆙	䰫
𱆚	䫥
𱆛	魗
𱇍	䰲
𱇎	𬵂
𱇏	魠
𱇐	魭
𱇑	䰽
𱇒	魮
𱇓	魱
𱇔	魶
𱇕	䰻
𱇖	魬
𱇗	鯩
𱇘	魧
𱇙	魫
𱇚	䱅
𱇛	鮇
𱇜	魼
𱇝	魾
𱇞	䱇
𱇟	魻
𱇠	鮂
𱇡	鮏
𱇢	鮌
𱇣	鱍
𱇤	䱂
𱇥	䱎
𱇦	鮬
𱇧	鮧
𱇨	鮛
𱇩	鱎
𱇪	鮥
𱇫	𩶯
𱇬	䱌
𱇭	鯠
𱇮	𩷶
𱇯	鮹
𱇰	䱒
𱇱	鯈
𱇲	䱐
𱇳	鮻
𱇴	𩹾
𱇵	鰿
𱇶	鯥
𱇷	䱜
𱇸	鱦
𱇹	䱥
𱇺	鯚
𱇻	䱤
𱇼	鯦
𱇽	䱡
𱇾	鯮
𱇿	鱐
𱈀	䱟
𱈁	鯅
𱈂	鰅
𱈃	𩹂
𱈄	鯸
𱈅	鯼
𱈆	䱾
𱈇	䱭
𱈈	䱴
𱈉	鰬
𱈊	鰡
𱈋	鰝
𱈌	鱃
𱈍	鰯
𱈎	𩺞
𱈏	鱁
𱈐	鱄
𱈑	鰴
𱈒	䲉
𱈓	鱏
𱈔	𩻛
𱈕	鱕
𱈖	䲚
𱈗	鱬
𱈘	鱨
𱈙	鱴
𱈚	鱷
𱈛	䲛
𱈜	鱻
𱉇	鳦
𱉈	鳭
𱉉	𬶼
𱉊	鳱
𱉋	𩾝
𱉌	鸃
𱉍	鳿
𱉎	鳺
𱉏	鷒
𱉐	鵙
𱉑	鳻
𱉒	𩿊
𱉓	鳸
𱉔	鴂
𱉕	鴚
𱉖	䲹
𱉗	鴠
𱉘	鴡
𱉙	䳅
𱉚	鴩
𱉛	鴙
𱉜	𩿧
𱉝	鵖
𱉞	䳇
𱉟	鸅
𱉠	鵛
𱉡	鴘
𱉢	鴢
𱉣	𪀚
𱉤	䳏
𱉥	鴶
𱉦	䳓
𱉧	䳒
𱉨	鵶
𱉩	鴺
𱉪	鴱
𱉫	鴸
𱉬	鷮
𱉭	𪀗
𱉮	鵅
𱉯	鴹
𱉰	鸒
𱉱	鶤
𱉲	鴾
𱉳	鷶
𱉴	鸉
𱉵	鶆
𱉶	䳚
𱉷	𪁛
𱉸	鵌
𱉹	鵗
𱉺	䳕
𱉻	鵎
𱉼	䳭
𱉽	鵋
𱉾	鵕
𱉿	鵔
𱊀	鵱
𱊁	鵸
𱊂	䳟
𱊃	鵹
𱊄	鶃
𱊅	鵻
𱊆	鵵
𱊇	鵴
𱊈	鶂
𱊉	𪈔
𱊊	鵼
𱊋	鵳
𱊌	鶋
𱊍	鵽
𱊎	鶅
𱊏	鶝
𱊐	鶛
𱊑	鶞
𱊒	鶢
𱊓	䳮
𱊔	𪃃
𱊕	鶙
𱊖	鶟
𱊗	鶔
𱊘	鶨
𱊙	䳲
𱊚	鷏
𱊛	鶽
𱊜	𪈼
𱊝	鶶
𱊞	𪄠
𱊟	鶷
𱊠	鷋
𱊡	鷕
𱊢	鷑
𱊣	䳺
𱊤	鷛
𱊥	𪄲
𱊦	鷧
𱊧	鷢
𱊨	𪆫
𱊩	鷵
𱊪	䴇
𱊫	鸆
𱊬	鸀
𱊭	鸒
𱊮	鸁
𱊯	鸄
𱊰	鷾
𱊱	鸐
𱊲	𪇰
𱊳	鸓
𱊴	𪈏
𱊵	鸙
𱊺	𪉖
𱊻	𪉣
𱊼	䴝
𱊽	𪊉
𱋂	𪋈
𱋄	𪋽
𱋅	𪋼
𱋆	䴮
𱋇	麧
𱋈	𪍿
𱋉	𪌐
𱋊	䴲
𱋋	麮
𱋌	𪌗
𱋍	𪌘
𱋎	䴳
𱋐	麯
𱋑	𪍷
𱋓	𪌣
𱋔	䴵
𱋕	𪌬
𱋖	麱
𱋗	䴸
𱋘	𪌮
𱋙	䴹
𱋚	𪌾
𱋜	𪍇
𱋝	䴺
𱋟	𪍒
𱋠	𪍍
𱋡	𪍣
𱋢	𪍑
𱋣	𪍚
𱋤	𪍘
𱋥	𪍓
𱋦	𪍞
𱋨	𪍬
𱋪	䵂
𱋫	䵃
𱋬	𪍴
𱋭	𪎂
𱋮	䵆
𱋱	黂
𱋴	䵐
𱋶	黸
𱋾	鼀
𱋿	鼁
𱌀	𪓛
𱌁	䵶
𱌃	䵷
𱌄	鼅
𱌅	𪓬
𱌆	鼆
𱌇	鼈
𱌈	𪓹
𱌉	鼊
𱌊	鼚
𱌏	鼲
𱌕	𪖨
𱌖	齈
𱌗	齌
𱌘	齍
𱌙	𪗋
𱌫	齞
𱌬	齚
𱌭	齺
𱌮	齣
𱌯	齝
𱌰	䶧
𱌱	齥
𱌲	齤
𱌳	齳
𱌴	𪘨
𱌵	䶨
𱌶	齱
𱌷	𪘬
𱌸	𪘥
𱌹	齵
𱌺	齻
𱌼	𪙉
𱌽	齸
𱍁	龏
𱍂	龖
𱍄	𪚮
𱍅	𪚭
𱍆	𪚰
𱍇	䶱
𱍈	龞
𱍉	𪛕
