三藩市	舊金山
上哈爾茨	上哈茲
上哈茨	上哈茲
上奧地利州	上奧地利邦
上沃爾特	上伏塔
上荷蘭	艾霍蘭
下奧地利州	下奧地利邦
下薩克森州	下薩克森邦
不來梅	布萊梅
不來梅哈芬	布萊梅港
不來梅州	布萊梅邦
不倫瑞克	布藍茲維
不列顛哥倫比亞	英屬哥倫比亞
不萊梅	不來梅 布萊梅
不萊梅州	布萊梅邦
不萊梅港	布萊梅港
丘胡伊夫	楚胡伊夫
丹帕沙	登巴薩
主權根據地區	主權基地區
乃磨	納奈莫
乍得	查德
也門	葉門
些路士	塞爾西
亞倫	雅連
亞克羅提利	德凱利亞
亞克羅提利和德凱利亞	亞克羅提利與德凱利亞
亞拉倫拉	雅拉倫拉
亞拉巴馬	阿拉巴馬
亞歷山大港	亞歷山卓
亞沃里夫	亞沃利夫
亞琛	阿亨
亞的斯亞貝巴	阿迪斯阿貝巴
亞皆老	阿蓋爾
亞穆蘇克羅	雅穆索戈
亞細安	東協
亞細安組織	東南亞國家協會
亞豐素克勞迪烏	阿風索克勞迪歐
亞辛	雅欣
亞速爾群島	亞速群島
亞厘畢	艾伯特
亞馬孫	亞馬遜
京士惇	京斯頓
京士頓	京斯惇 京斯頓 金石城
什切青	斯塞新
什未林	施威林
什羅普	施洛普
什魯斯伯里	士魯斯柏立 舒茲伯利
仙童半導體	快捷半導體
代爾夫特	臺夫特
伊凡	伊瓦諾
伊利沙伯港	伊莉莎白港
伊利諾伊	伊利諾
伊利近	埃爾金
伊卡盧伊特	伊魁特
伊斯坦布爾	伊斯坦堡
伊斯梅爾	依斯邁
伊斯蘭堡	伊斯蘭瑪巴德
伊斯靈頓	伊斯林頓
伊普斯維奇	伊普斯威奇
伊比利亞	伊比利
伊洛伊洛	怡朗
伊珀爾	伊伯
伊納姆克洛	伊南克洛
伊萬諾	伊凡諾 伊瓦諾
伊靈	伊令
伊麗莎白港	伊利沙伯港 伊莉莎白港
伍德蘭	森林地
伍珀塔爾	烏帕塔
伍珀河	烏帕河
伏伊伏丁那	佛伊弗迪納
休斯惇	休士頓
休斯頓	休士頓
伯克利	柏克萊
伯利玆	貝里斯
伯利茲	貝里斯
伯恩利	班來
伯恩賽德	濱世
伯明翰	伯明罕
伯爾尼	伯恩
伯班克	柏本克
佐治	喬治
佐治亞州	喬治亞州
佐治城	喬治城
佐治河	喬治斯河
佛得角	維德角
佛羅倫薩	佛羅倫斯
佛蘭德	法蘭德斯
佩格尼茨	佩格尼茲
佩納姆	卑尼咸
佩萊利烏	佩里琉 貝里琉
佳德	克萊德
依布拉欣	伊布拉欣
依路	怡朗
侯城	赫爾河畔京斯惇
侯斯頓	休士頓
侯河	赫爾河
侯賽因	胡先
侯賽因·奥恩	胡先翁
俄克拉荷馬	奧克拉荷馬
俄克拉荷馬城	奧克拉荷馬市
俄勒岡	奧勒岡
俄福	奧福德
保頓	波爾頓
修咸頓	南安普惇
修夫基	索斯蓋特
修打蘭	薩瑟蘭
修適士	薩塞克斯
倫巴第	倫巴底
倫惇城	倫惇市
傅里葉	傅立葉
傑爾	焦爾
僑福	基爾福
先吉列伊	森吉列伊
克恩頓	卡林西亞
克恩頓州	卡林西亞邦
克拉倫斯	嘉蘭士
克拉倫斯公園	嘉蘭士柏
克拉勒姆	克拉蘭
克拉珀姆	克萊姆
克珀尼克	哥本尼克
克羅伊茨貝格	十字山
克羅地亞	克羅埃西亞
克里沃羅格	克利福洛
克雷費爾徳	克雷費德
克馬德克	克馬得
內政和國土部	內政和家園部
內比都	奈比多
內爾斯普雷特	尼爾斯普魯特
內羅比	奈洛比
內羅畢	奈洛比
共和聯邦	大英國協
兵基蘭	布林格蘭
兼士比	格里姆斯比
几內亞	幾內亞
几內亞比紹	幾內亞比索
凡登廣場	芳登廣場
凱撒斯勞滕	凱撒勞頓
凱沙羅頓	凱撒勞頓
凱科斯	凱可
凱諾拉	肯諾拉
切斯特勒斯特里特	赤斯特街
切斯特勒街	赤斯特街
切斯特菲爾德	赤斯特非
切柏咸	契朋罕
切爾滕納姆	卓特咸
切爾諾夫策	車尼夫契
切爾諾貝利	車諾比
切爾諾貝爾	車諾比
列支惇士登	列支惇斯登
列支敦士登	列支敦斯登
列斯	里茲
列治	列日
列治文	里奇蒙
別斯蘭	貝司蘭
利勒哈默爾	利樂漢瑪
利夫奧克	活橡
利奇菲爾德	利奇菲
利希滕貝格	里希坦伯格
利恩茨	利恩茲
利斯莫爾	立斯摩爾
利比里亞	賴比瑞亞
利沃夫	利維夫
利玆	里茲
利華古遜	勒沃庫森
利載拿	雷吉納
利隆圭	里朗威
利隆威	里朗威
利雅得	利雅德
刻赤	克赤
前波美拉尼亞	西波美拉尼亞
劉易舍姆	路易斯罕
劍頓	康登
加來	加萊
加來海峽	加萊海峽
加拉加斯	卡拉卡斯
加拉帕戈斯群島	加拉巴哥群島
加拿分	卡納封 卡納芬
加沙	加薩
加沙地帶	加薩走廊
加沙走廊	加薩走廊
加法爾	嘉化 惹化
加法爾·巴巴	嘉化峇峇
加泰羅尼亞	加泰隆尼亞
加的夫	卡地夫
加的斯	卡迪斯
加納	迦納
加蓬	加彭
努庫阿洛法	努瓜婁發
努拿烏特	努納福特
努瓦克肖特	諾克少
努納武特	努納福特
勃朗峰	白朗峰
勃蘭登堡	布蘭登堡
勃蘭登堡州	布蘭登堡邦
勒哈弗爾	利哈佛
勒布爾歇	勒布爾熱
勒拉赫	羅拉赫
勒芒	利曼
勒阿弗爾	利哈佛
勞工和社會保障部	勞動及社會事務部
勞特	魯特
北卡羅萊納	北卡羅來納
北安普頓	北安普惇
北嶼	沖北岩
北部省	諾爾省
北韓離脫住民定着支援事務所	北韓離脫住民定著支援事務所
匹黎哥	匹黎可
十三個殖民地	十三殖民地
千里達和多巴哥	千里達及托巴哥
卑詩	英屬哥倫比亞
南三文治	南桑威奇
南中國海	南海
南中國海礁岩	南海礁岩
南中國海礁島	南海礁島
南中國海礁石	南海礁石
南中國海礁群	南海礁群
南佐治亞	南喬治亞
南佐治亞及南三文治群島	南喬治亞與南桑威奇群島
南北韓首腦會晤	南北韓高峰會
南北韓首腦會談	南北韓高峰會
南卡羅萊納	南卡羅來納
南喀爾巴阡山脈	外西凡阿爾卑斯山
南喬治亞和南桑威奇群島	南喬治亞與南桑威奇群島
南奧塞梯	南奧塞提亞
南嶼	沖南岩
南澳大利亞	南澳
南澳大利亞州	南澳州
南里奧格蘭德州	南大河州
南里約格蘭州	南大河州
博伊西	波夕
博奈爾	波奈
博普塔茨瓦納	波布那
博洛尼亞	波隆納
博爾基亞	包奇亞
博爾扎諾	波爾察諾
博爾赫隆	波格倫
博爾頓	波爾頓
博瑟爾	巴薩爾
博登湖	波登湖
博茨瓦納	波札那
博蘭	波朗
占士	詹姆士
卡加延	卡加煙
卡塔爾	卡達
卡塞爾	卡瑟爾
卡姆登	康登
卡宴	開雲
卡托維玆	卡托維治
卡拉哈里沙漠	喀拉哈里沙漠
卡文	嘉弘
卡斯特里	卡斯翠
卡斯蒂利亞	卡斯提亞
卡斯魯厄	卡爾斯魯爾
卡昂	康城
卡普里	卡布里
卡爾加里	卡加利
卡爾卡松	卡卡頌
卡爾斯魯厄	卡爾斯魯爾
卡盧什	卡路什
卡米爾海	卡梅爾海
卡納溫	卡納封 卡納芬
卡納維拉爾角	卡納維爾角
卡素加	卡斯爾加
卡迪夫	卡地夫
卡那封	卡納封 卡納芬
卡那封溫	卡納芬
卡默斯	卡馬斯
危地馬拉	瓜地馬拉
危地馬拉城	瓜地馬拉市
危地馬拉市	瓜地馬拉市
厄瓜多爾	厄瓜多
厄立特里亞	厄利垂亞
厄頓	阿克頓
友誼礁	盟誼暗沙
古德伍德	高活
史卓咸	斯特里薩姆
史密斯菲爾德	史密斯菲
史提芬納治	史蒂文納吉
史樂	施洛普
史特加	司徒加特 斯圖加特
史篤城	斯托克城
史葛斯谷	史考茲谷
史雲斯	斯旺西
史雲頓	斯溫頓
吉布堤	吉布地
吉布提	吉布地
吉爾伯頓	喬拔頓
吉爾吉斯斯坦	吉爾吉斯
吉爾福德	基爾福
后海灣干線	后海灣幹線
吐芬奴	托菲諾
呂伐登	雷瓦登
呂德斯海姆	綠德斯翰
呂根	綠根
呂根島	綠根島
呂貝克	呂北克
呂貝克漢薩自由市	呂北克漢薩自由市
告羅士打	格洛斯特
和域	華威
和夫咸頓	伍爾弗漢普頓
咸美頓	哈密爾頓 漢密爾頓
咸美頓	漢彌爾頓 漢米頓
咸頓	漢普頓
咸默史密夫	漢默史密斯
哈利姆	哈林
哈利法斯	哈利法克斯
哈勒爾貝克	哈勒貝克
哈博羅內	嘉柏隆里
哈密	哈密德
哈密爾頓	漢彌爾頓
哈弗爾河	哈非爾河
哈德斯菲爾德	哈德斯菲
哈德森	哈德遜
哈桑	哈山
哈桑納爾	哈山納
哈爾施塔特	哈修塔特
哈爾茨	哈茲
哈特斯菲	哈德斯菲
哈特福德	哈特福
哈米德	哈密德
哈米迪	哈密迪
哈羅	哈洛
哈義礁	南屏礁
哈芝	哈吉
哈茨山	哈茲山
哈薩克斯坦	哈薩克
哈雷	哈勒
哈默史密斯	漢默史密斯
哈默爾恩	哈梅恩
哥倫坡	可倫坡
哥德堡	哥特堡
哥打列治	戈德里奇
哥斯達黎加	哥斯大黎加
哥特人	哥德人
哥特字母	哥德字母
哥特式	哥德式
哥特語	哥德語
哥特風	哥德風
唐卡士打	唐卡斯特
唐橋井	坦布里治威爾斯
喀斯喀特	喀斯開
喜士定	黑斯廷斯
喫茶小舖	喫茶小舖
喬治惇	喬治城
嘉拿多	科羅納多
嘉林邊	格蘭坪
嘉法	惹化
嘉立咸	克萊姆
嘉芙蓮	凱瑟琳
因弗內斯	印威內斯
因斯布魯克	茵斯布魯克
因紐特	因努伊特
圖文巴	圖翁巴
圖林根州	圖林根邦
圖森	土桑
圖爾	都爾
圖爾奈	土奈
圖瓦盧	吐瓦魯
圖盧玆	土魯斯
圖盧茲	土魯斯
圖賴訥	都蘭
土庫曼斯坦	土庫曼
土阿莫土	土亞莫土
圭亞那	蓋亞那
圭內斯	格溫內斯
坎伯韋爾	康伯威爾
坎大哈	坎達哈
坎帕拉	康培拉
坎特伯雷	坎特伯里
坎盧普斯	甘露
坎貝爾惇	金寶城
坎貝爾里弗	坎貝爾河
坦噶尼喀	坦干伊加
坦布里奇韋爾斯	坦布里治威爾斯
坦桑尼亞	坦尚尼亞
埃克塞特	艾希特
埃因霍溫	恩荷芬
埃塞俄比亞	衣索比亞
埃塞克斯	艾塞克斯
埃夫拉塔	艾夫拉塔
埃弗拉德	愛華勒
埃弗拉德帕克	愛華勒柏
埃德蒙頓	愛德蒙頓 愛蒙頓
埃文	雅芳
埃斯科	艾斯科
埃朗根	愛爾朗根
埃爾丁	艾丁
埃爾克利訥	艾克利內
埃爾斯米爾	艾厄士米爾
埃爾朗根	愛爾朗根
埃爾比勒	艾比爾
埃爾特姆	艾珊
埃爾福特	艾福特
埃維亞	尤比亞
埃迪爾內	愛第尼
埃里溫	葉里溫
域斯咸	雷克斯漢姆
域治	威治
域菲	威克菲
域菲路	韋克菲爾德
基加利	吉佳利
基奇納	基秦拿
基洛沃格勒	基洛夫格勒
基洛納	基隆拿
基督山	基度山
基羅納	赫羅納
基耶蒂	基替
基里巴斯	吉里巴斯
堅伯威	康伯威爾
堪培拉	坎培拉
塔吉克斯坦	塔吉克
塔姆沃思	譚沃思
塔希提	大溪地
塔拉哈西	塔拉赫西
塔斯曼尼亞	塔斯馬尼亞
塔斯曼尼亞州	塔斯馬尼亞州
塔村	哈姆雷特塔
塔爾薩	土爾沙
塔那那利佛	安塔那那利佛
塞拉利昂	獅子山
塞浦路斯	塞普勒斯 賽普勒斯
塞爾扣克	塞爾寇克
塞爾維亞和黑山	塞爾維亞與蒙特內哥羅
塞瓦斯托波爾	塞凡堡
塞維利亞	塞維亞
塞舌爾	塞席爾
塞黑	塞蒙
墨累	美利
墨西拿	美西納
士他令	史特靈
士多蒙	史托蒙特
士德頓	史塔克頓
士瓦本	施瓦本
士美菲	史密斯菲
夏力	哈萊克
夏延	夏安
夏洛滕堡	夏洛騰堡
夏洛特頓	夏洛特惇
夏灣拿	哈瓦那
夏靈基	哈林蓋
多佛爾	多佛
多哈	杜哈
多多馬	杜篤瑪
多實	多塞特
多洛米蒂	多羅米提
多米尼加	多明尼加
多臣隙	道森河
多蒙特	多特蒙德
大不列顛及北愛爾蘭聯合王國	大不列顛暨北愛爾蘭聯合王國
大不列顛及愛爾蘭聯合王國	大不列顛暨愛爾蘭聯合王國
大本鐘	大笨鐘
大陸架	大陸棚
夸賈林	瓜加林
奇切斯特	奇徹斯特
奇司威克	奇西克
奇彭納姆	契朋罕
奔薩	朋札
奧伊彭	歐伊朋
奧克拉荷馬城	奧克拉荷馬市
奧卡拿根	奧肯拿根
奧咸	奧丹
奧塞梯	奧塞提亞
奧弗佩爾特	奧弗佩特
奧恩·加法尔	翁惹化
奧文尼	奧弗涅
奧斯坦德	奧斯滕德
奧斯曼	鄂圖曼
奧斯汀	奧斯丁
奧斯特利茨	奧斯特里茲
奧斯特里茨	奧斯特里茲
奧斯納布克	奧斯納貝克
奧斯納布呂克	奧斯納貝克
奧格斯堡	奧古斯堡
奧比斯波	奧比斯保
奧沙瓦	奧沙華
奧波萊	奧波列
奧爾巴尼	奧巴尼 阿伯尼
奧爾弗里頓	奧斐頓
奧爾德姆	奧丹
奧爾登堡	歐登堡
奧登堡	歐登堡
奧赫蒂爾卡	阿克提卡
奧迪沙	敖得薩
奧雲	歐文
奧雲灣	歐文灣
奧馬	奧瑪
奧馬爾	奧瑪
奧馬魯	奧瑪魯
女王大學	皇后大學
姆巴巴內	墨巴本
姆巴巴納	墨巴本
始路	特雷爾
威士拿	惠斯勒
威廉斯塔德	威廉城
威斯康星	威斯康辛
威斯敏斯特	西敏
威斯敏斯特修道院	西敏寺
威斯敏斯特宮	西敏宮
威斯敏斯特教堂	西敏寺
威斯敏斯特聖彼得牧師團教堂	西敏市聖彼得牧師團教堂
威斯敏斯特體系	西敏制
威斯特法倫	西伐利亞 西發利亞
威根	維根
威爾士	威爾斯
威爾明頓	威明頓
威特沃特斯蘭德	維瓦特斯蘭
孔茨	康茲
孚日	佛日
孟菲斯	曼非斯
孫德爾本斯	巽德班
安克雷奇	安克拉治
安利公園	安利柏
安圭拉	安吉拉
安域	阿因維克
安德列治	安德萊赫特
安提瓜和巴布達	安地卡及巴布達
安條克	安提阿克
安瓦爾	安華
安的列斯	安地列斯
安第斯	安地斯
安納海姆	安那翰
安蒂特姆	安提頓
安道爾城	老安道爾
安達盧西亞	安達魯西亞
宣德班	巽德班
宿務	宿霧
密歇根	密西根
密爾布瑞	米爾布雷
密爾沃基	密爾瓦基
密芝根	密西根
富勒頓	富來頓
富咸	富勒姆
富圖納	富圖那
富爾達	佛萊辛
寬扎	廣薩
對朝政策	對北政策
對衡	達拉謨
小石城	小岩城
尚佩恩	香檳
尚布賴萊圖爾	尚布賴萊都爾
尚貝里	香貝里
尤卡坦	猶加惇
尼亞加拉	尼加拉
尼亞美	尼阿美
尼德寧	納蒂靈
尼披盛	尼皮辛
尼日利亞	奈及利亞
尼日爾	尼日
尼爾堡	紐堡
尼科西亞	尼柯西亞
尼美根	奈梅亨
尼雪平	尼科平
居斯塔維亞	古斯塔維亞
屈福特	瓦特福
屋威老	奧克維爾
屋崙	奧克蘭
山靜咸	桑德令罕
岡比亞	甘比亞
岩哈拉	安哈拉
峇卡	巴卡
峇釐	峇里
己連加利	葛蘭蓋瑞
己連圍	格倫維爾
巴丁宜阿里淺灘	南康暗沙
巴伐利亞州	巴伐利亞邦
巴佛士	巴瑟斯特
巴兆惇	巴休惇
巴克	白加
巴利亞多利德	瓦拉多利德
巴利阿里	巴利亞利
巴利阿里群島	巴利亞利群島
巴勒莫	巴勒摩
巴卡爾	巴卡
巴吞魯日	巴頓魯治
巴域	伯立克
巴塞羅那	巴塞隆納
巴塞隆拿	巴塞隆納
巴富	伯斯 珀斯
巴尼特	巴內特
巴巴多斯	巴貝多
巴布亞新几內亞	巴布亞紐幾內亞
巴布亞新幾內亞	巴布亞紐幾內亞
巴布亞新畿內亞	巴布亞紐幾內亞
巴布延	巴布煙
巴拉福特	布拉福
巴摩盧	巴摩拉
巴斯托涅	巴斯通
巴斯特爾	巴士地
巴斯蒂亞	巴斯提亞
巴新	巴紐
巴林塘	巴林坦
巴爾米拉	巴美拉
巴爾莫勒爾	巴摩拉
巴特爾克里克	巴特溪
巴符州	巴符邦
巴約訥	貝雲
巴芙	巴斯
巴西爾登	巴休惇
巴赫穆特	巴赫姆特
巴達維	巴達威
巴釐	峇里
布倫海姆	布倫亨
布倫特里	布雷恩垂
布力希斯	布萊克希斯
布力般	布拉克本
布基納法索	布吉納法索
布恰	布查
布拉卡	布拉干
布拉德福德	布拉福
布拉柴	布拉薩
布拉柴維爾	布拉薩市
布拉班特	布拉邦
布拉迪斯拉發	布拉提斯拉瓦
布林斯貝利	布魯姆斯伯里
布法羅	水牛城
布爾戈斯	布哥斯
布爾根蘭	布根蘭
布爾根蘭州	布根蘭邦
布瓊布拉	布松布拉
布痕瓦爾德	布亨瓦德
布盧姆茨伯里	布魯姆斯伯里
布羅姆利	布倫來
布羅瓦里	布洛瓦利
布萊克本	布拉克本
布萊克浦	黑潭
布萊斯瓦利	布萊斯河谷
布蘭太爾	布蘭岱
布賴頓	布萊頓
布里奇沃特	必列者窩打
布里奇波特	橋港
布里奇頓	橋鎮
布里斯托爾	布里斯托
布里斯托爾路	布里斯托路
布里斯班	布里斯本
布隆方丹	布隆泉
布隆迪	蒲隆地
布雷根茨	布雷根茲
布靈厄蘭	布林格蘭
布靈頓	伯靈頓
希思羅	希斯洛
希斯路	希斯洛
希沙慕丁	希山慕丁
希邁	希梅
帕丁頓	派丁頓
帕克賽德	柏世
帕利基爾	帕里克爾
帕勒莫	巴勒摩
帕勞	帛琉
帕拉馬里博	巴拉馬利波
帕瑞納	帕拉納
帕皮提	巴比提
帕邁拉	巴美拉
帝力	狄力
席車士打	奇徹斯特
干諾	康諾特
幾內亞比紹	幾內亞比索
庫夫施泰因	庫夫斯坦
庫拉索	古拉索
庫爾德	庫德
庫賽埃	科斯雷
康和	康瓦爾 康瓦耳
康埃克呂斯	坎埃克呂斯
康城	坎城
康山	康希爾
康斯坦茨	康士坦茲
康樂	康諾特
康沃爾	康瓦爾 康瓦耳
康涅狄格	康乃狄克
延文禮士	印威內斯
廷布	辛布
弗吉尼亞	維吉尼亞
弗拉芒	佛拉蒙 佛萊明
弗爾訥	福恩
弗留利	佛里烏利
弗羅茨瓦夫	弗次瓦夫
弗羅西諾內	佛羅西羅內
弗萊福蘭	夫利佛蘭
弗蘭科夫斯克	法蘭科夫斯克
弗蘭肯地區	法蘭克尼亞地區
弗蘭肯行政區	法蘭克尼亞行政區
弗賴堡	弗萊堡
弗里堡	佛立堡
弗里斯蘭	菲士蘭
弗里曼特爾	費里曼圖
弗里西亞	非里西亞
弗隆特納克	芳堤娜
弗雷德里克	菲德里克
弗雷德里克頓	腓特烈頓
弗雷斯諾	佛雷斯諾
弼	比特
彼得伯勒	彼得堡 彼得波羅
彼德堡	彼得波羅
律倫	拉特蘭
得克薩斯	德克薩斯
得州	德州
得梅因	狄蒙
德基利亞	德凱利亞
德意志邦聯	日耳曼邦聯
德拉肯斯山脈	龍山山脈
德梅因	狄蒙
德涅斯特	聶斯特
德班	德爾班
德累斯頓	德勒斯登
德芙靈	達弗林
德薩斯	德克薩斯
德蘭士瓦	川斯瓦
德賴河	乾河
德雲	德文
必嘉島	貝克島
必嘉街	貝克街
快富	法夫
恩菲	恩菲特
恩菲爾德	恩菲特
恩賈梅納	恩加美納
悉尼	雪梨
惇刻爾克	惇克爾克
惠特徹奇	維特祖治
惠特沃斯	維特沃斯
惠靈頓	威靈頓
惹法	惹化
意大利	義大利
意屬	義屬
意屬利比亞	義屬利比亞
意屬索馬里	義屬索馬利
愛德華茲惇	愛德華城
愛森納赫	艾森納赫
愛民頓	愛德蒙頓 愛蒙頓
愛爾福特	艾福特
愛特咸	艾珊
愛蘭立	厄於拉訥
慕斯達法	穆斯塔法
慕禮	莫里
慕遜加柏	慕森加柏
懷特霍斯	白馬市
戈斯福德	高士福
戛納	坎城
戛納埃克呂斯	坎埃克呂斯
所羅門羣島	索羅門羣島
扎因丁	再努丁
扎波羅熱	札波羅熱
打比	德比
托倫斯	多倫士
托利斯	托列斯
托斯卡納	托斯卡尼
托皮卡	托彼卡
托萊多	托雷多
托雷斯	托列斯
托馬斯	湯瑪士
扶蓮	弗林特
拉亞礁	光星礁
拉各斯	拉哥斯
拉塞爾	羅素
拉夫伯勒	拉夫堡
拉央拉央島	彈丸礁
拉希德	拉昔
拉惹加隆淺灘	北康暗沙 義淨礁
拉扎克	拉薩克
拉斐特	拉法葉
拉斯羅普	萊思羅普
拉曼恰	拉曼查
拉素	拉吉歐
拉薩	拉薩克
拉赫曼	拉曼
拉韋洛	拉維洛
拉齊奧	拉吉歐
拜仁州	拜仁邦
拜恩州	拜恩邦
拜洛特	拜律特
拜羅伊特	拜律特
拿波利	拿坡里
拿督打立礁	隠波暗沙
拿騷	拿索
捷爾諾波爾	特諾皮爾
措必列治	特羅布里奇
揚德納島	延德納島
摩加迪沙	摩加迪休
摩澤爾	莫瑟爾
撒丁	薩丁尼亞
敖德薩	敖得薩
數字化和交通部	數位及交通部
數碼及交通部	數位及交通部
文丁破礁	瓊台礁
文萊	汶萊
文萊達魯薩蘭國	汶萊和平之國
文西德爾	文西德
文達	溫達
斯圖加特	司徒加特
斯坦福	史丹福
斯塔沃洛	斯塔弗洛
斯塔福德	史丹佛
斯威士蘭	史瓦帝尼 史瓦濟蘭
斯庫台	士科德
斯托克頓	史塔克頓
斯托蒙特	史托蒙特
斯普利特	史普利特
斯普林菲爾德	春田市
斯泰克方丹	史泰克方丹
斯洛文尼亞	斯洛維尼亞
斯海弗寧恩	席凡寧根
斯海爾德	須耳德
斯溫登	斯溫頓
斯特拉斯堡	史特拉斯堡
斯特拉特福	史特拉福
斯特里漢姆	斯特里薩姆
斯特雷特姆	斯特里薩姆
斯特靈	史特靈
斯科普里	史高比耶
斯科茨谷	史考茲谷
斯華坦尼奧	芝華塔尼歐
斯蒂夫尼奇	史蒂文納吉
斯里巴加灣	斯里巴卡旺
新不倫瑞克	新布藍茲維
新佐治亞	新喬治亞
新几內亞	新幾內亞
新南威爾士	新南威爾斯
新南威爾士州	新南威爾斯州
新奧爾良	紐奧良
新威斯敏斯特	新西敏
新布蘭斯威	新布藍茲維
新帕扎爾	新帕札
新斯科舍	新斯科細亞
新港	紐波特
新澤西	紐澤西
新特蘭	巽德蘭
新畿內亞	新幾內亞
新罕布什爾	新罕布夏
新莫斯科夫斯克	新莫斯科斯克
新西蘭	紐西蘭
施他佛	史丹佛
施普利特	史普利特
施普雷	史普雷
施泰格利茨	史泰格利茲
施泰爾	斯泰爾
施泰爾馬克	史泰爾馬克
施泰爾馬克州	史泰爾馬克邦
施派爾	斯派爾
施潘道	斯潘道
施特拉爾松德	史特拉頌
施瓦本	士瓦本
施維茨	舒維茲
施蒂利亞	史泰利亞
施蒂利亞州	史泰利亞邦
施蒂里亞	史泰利亞
施蒂里亞州	史泰利亞邦
施韋因富特	什文福
施龐達勒姆	斯潘達勒姆
日占朝鮮	日佔朝鮮
旺多姆廣場	芳登廣場
旺玆沃思	旺茲沃斯
旺阿玆莎	旺阿芝莎
旺阿茲莎	旺阿芝莎
昂代訥	安登
昂古萊姆	安古蘭
昆士柏	女王公園
明尼阿波利斯	明尼亞波利斯
易卜拉欣	伊布拉欣
普利茅夫	普利茅斯
普勒陀尼亞	普勒托利亞
普拉亞	培亞
普林普頓	拔林惇
普林普頓帕克	拔林惇柏
普法爾茨	普法茲 法爾茲
普法茨	法爾茲
普福爾茨海姆	佛茨海姆
普羅斯佩克特	蒲庶庇
普萊西德湖	寧靜湖
普里什蒂納	普里斯提納
普雷斯科特	普雷史考特
景隆	坎農
智利域	奇利瓦克
暗士黨	阿姆斯特朗
曉倫	休倫
曼克頓	曼哈頓
曼圖亞	曼托瓦
曼尼多巴	曼尼托巴
曼尼托巴	緬尼托巴
曼斯菲爾德	曼斯菲爾
曼斯菲特	曼斯菲爾
曼特卡	曼提加
曼達納尼礁	南海礁
朝方	北韓方面
朝韓	南北韓
朝韓首腦會晤	南北韓高峰會
朝鮮	北韓
朝鮮中央電視台	朝鮮中央電視臺
朝鮮以及韓國	北韓以及南韓
朝鮮及韓國	北韓及南韓
朝鮮同韓國	北韓同南韓
朝鮮和韓國	北韓和南韓
朝鮮戰爭	韓戰
朝鮮文學藝朮總同盟	朝鮮文學藝術總同盟
朝鮮日占	朝鮮日佔
朝鮮獨立運動	韓國獨立運動
朝鮮與韓國	北韓與南韓
本拿比	柏納比
札法爾	惹化
朱拉島	侏羅島
朴次茅斯	樸茨茅斯
李斯特	萊斯特
李治菲特	利奇菲
杜塞爾多夫	杜塞道夫
杜尚別	杜尚貝
杜斯多夫	杜塞道夫
杜根咸	達根罕
杰克遜	傑克森
杰克遜維爾	傑克孫維
杰斐遜城	傑佛遜城
杰森	傑克森
杰森維爾	傑克孫維
杰爾	焦爾
東南亞國家聯盟	東南亞國家協會
東古	東姑
東古·阿卜杜勒·拉赫曼	東姑·阿布都拉曼
東咸	東罕
東哥特	東哥德
東姑阿都拉曼	東姑·阿布都拉曼
東寶庭	惇巴頓
東漢姆	東罕
東盟	東協
林吉特	令吉
林茨	林茲
林雪平	林雪坪
柏京	巴金
柏嘉	包奇亞
柏寧礁	榆亞暗沙
柏林州	柏林邦
柏靈頓	派丁頓
查化	惹化
查戈斯	查哥斯
查洛頓	夏洛特惇
查靈	查令
柯士甸	奧斯丁
根德	肯特
格倫加里	葛蘭蓋瑞
格倫奧斯蒙德	己連柯士文
格域	蓋威克
格士黑德	蓋茲赫德
格拉德斯通	格列士惇
格拉拿達	格拉納達
格拉茨	格拉茲
格林尼治	格林威治
格林納達	格瑞那達
格林貝	綠灣
格洛瑟普	格羅索普
格洛索普	格羅索普
格爾利茨	哥利茲
格萊內爾格	己連拿奴
格蘭扁	格蘭坪
格賴夫斯瓦爾德	格來斯瓦德
格魯吉亞	喬治亞
桑德蘭	巽德蘭
桑德貝	雷灣
桑德靈厄姆	桑德令罕
桑托斯將軍城	三投斯將軍市
桑治奧	松德里奧
桑給巴爾	尚吉巴
梅加瓦蒂	梅嘉娃蒂
梅德韋	麥德威
梅赫倫	麥赫連
梯林斯	提林斯
梳利侯	索利赫爾
梳士巴利	索爾茲伯里 索茲伯里
梳士貝利	士魯斯柏立
棉登	明登
棉蘭老	民答那峨
棉蘭老島	民答那峨島
森麻實	索美塞特
楚格峰	祖格峰
樸茨茅夫	樸茨茅斯
歌來頓	克羅伊登
歐拉	尤拉
歐文桑德	歐文灣
歐邦日	奧班吉
歸融語	克里奧爾語
比亞里茨	比亞希茲
比什凱克	比斯凱克
比利牛斯	庇里牛斯
比勒費爾德	比勒菲爾德
比勒陀利亞	普勒托利亞
比立勤	布拉干
比肯斯菲爾德	比更士菲
比路賀利桑特	美景市
毛爾布龍	毛布朗
毛里塔尼亞	茅利塔尼亞
毛里求斯	模里西斯
毛里裘斯	模里西斯
汝拉	侏羅
汝拉山	侏羅山
汝拉州	侏羅州
汶萊達魯薩蘭國	汶萊和平之國
沃倫	伏林
沃克斯豪爾	沃克斯霍爾
沃克維爾	獲加圍
沃州	佛德州
沃森維爾	華生維爾
沃爾夫斯堡	狼堡
沃爾夫斯貝格	沃爾夫斯伯格
沃爾姆斯	沃姆斯
沃爾瑟姆斯托	沃爾珊斯托
沃爾瑟姆福里斯特	瓦爾珊森林
沃爾索爾	沃索爾
沃特福德	瓦特福
沃特頓	瓦特頓
沃里克	華威
沙勒羅瓦	夏勒華
沙合礁	海安礁
沙吉礁	海寧礁
沙問暗	薩蒙阿姆
沙地	沙烏地
沙地阿拉伯	沙烏地阿拉伯
沙尼亞	薩尼亞
沙尼治	薩尼奇
沙必里	沙比利
沙托魯	夏托魯
沙斯加通	薩斯喀屯
沙斯卡寸旺	薩克其萬 薩斯喀徹溫
沙末	薩馬德
沙比里	沙比利
沙特	沙烏地
沙特阿拉伯	沙烏地阿拉伯
沙馬德	薩馬德
泄蘭	昔得蘭
法屬波利尼西亞	法屬玻里尼西亞
法恩伯勒	法恩堡
法戈	法哥
法梅訥	法梅恩
法爾斯	瓦爾斯
波什尼亞克	波士尼亞克
波倫亞	波隆納
波利尼西亞	玻里尼西亞
波基亞	包奇亞
波多諾伏	新港
波德戈里察	波德里查
波恩	波昂
波斯尼亞	波士尼亞
波斯尼亞和黑塞哥維那	波士尼亞與赫塞哥維納
波斯尼亞黑塞哥維那	波士尼亞赫塞哥維納
波爾塔瓦	波塔瓦
波珀靈厄	波佩林厄
波美恩	波莫瑞
波美拉尼亞	波莫瑞
波英	波茵
波茨坦	波茲坦
波黑	波赫
泰因	泰恩
泰益·馬哈茂德	泰益瑪目
泰米爾	坦米爾
洛磯	落磯
洛蒙德	洛蒙
洛迪	洛戴
洛達咸	羅瑟勒姆
津巴布韋	辛巴威
洪都拉斯	宏都拉斯
活士	伍玆
活特頓	瓦特頓
海格特	海機治
海爾布隆	海布隆
海馬礁	南安礁
淡米爾	坦米爾
深圳灣	后海灣
清奈	欽奈
渭州	威爾特
湯加	東加
溫切斯特	溫徹斯特
溫尼辟	溫尼伯
溫布爾登	溫布頓
溫布萊	溫布利
溫得和克	溫荷克
溫特窩夫	溫特沃斯
溫納圖萬	那杜
溫車士打	溫徹斯特
滿地可	蒙特婁
漆咸	查塔姆
漢密爾頓	漢米頓
澤凱利亞	德凱利亞
澳大利亞	澳洲
澳大利亞聯邦	澳洲聯邦
澳洲	澳大利亞
灣斯禾夫	旺茲沃斯
火奴魯魯	檀香山
烏帕塔爾	烏帕塔
烏得勒支	烏特勒支
烏德勒支	烏特勒支
烏普頓	厄普頓
烏格都古	瓦加杜古
烏比烏比礁	光星仔礁
烏爾姆	烏姆
烏玆別克斯坦	烏茲別克
烏茲別克斯坦	烏茲別克
烏赫爾	烏格爾
烏隆迪	烏隆地
無憂宮	忘憂宮
熱納普	日內普
燕豪芬	恩荷芬
特倫特河畔史篤	特倫特河畔斯托克
特倫甘納	泰倫加納
特倫蒂諾	特倫提諾
特倫頓	翠登
特克斯	土克
特克斯和凱科斯	土克凱可
特克斯和凱科斯群島	土克凱可群島
特古西加爾巴	德古西加巴
特拉華州	德拉瓦州
特普利釆	特普利策
特立尼達和多巴哥	千里達及托巴哥
特蘭斯凱	川斯凱
特雷斯登	德勒斯登
特雷西	雀西
特魯瓦	特華
特魯華	特華
獨聯體	獨立國協
獲素	沃克斯霍爾
珀斯	伯斯
班列特	巴內特
班吉	班基
班布里奇	班布里治
班珠爾	班竹
班迪哥	本迪戈
琳吉礁	法顯暗沙
琳寶	蘭貝斯
瑙魯	諾魯
瑟比利	薩德伯里
瓜德羅普	瓜地洛普
瓜達爾卡納爾	瓜達康納爾
瓦加瓦加	沃加沃加
瓦努阿圖	萬那杜
瓦哈比	瓦哈
瓦杜玆	瓦都茲
瓦爾訥通	瓦內頓
瓦茨曼	瓦茲曼
瓦萊塔	瓦勒他
甘岡	干貢
甘馬粦	甘馬仁
申根協議	申根公約
留尼汪	留尼旺
畢爾巴鄂	畢爾包
畿內亞	幾內亞
畿內亞比紹	幾內亞比索
登地	丹地
登巴	鄧巴
登巴薩	丹帕沙
登打士	鄧達斯
發羅拉	夫羅勒
白石灘	澄平礁
白禮頓	布萊頓
白蘭軒	布倫亨 布林德海姆
百慕大	百慕達
百福	貝德福
皆因	開雲
皮利士葛	普雷史考特
皮姆利科	匹黎可
皮特凱恩	皮特肯
盧塞恩	琉森
盧布爾雅那	盧比安納
盧旺達	盧安達
盧瓦爾河	羅亞爾河
盧瓦羅克桑斯	羅亞羅克桑斯
盧薩卡	路沙卡
真尼沙	肯尼茲
石勒蘇益格	什列斯威 什勒斯維希
石荷州	什霍邦
砵蘭	波特蘭
硅谷	矽谷
碧勤翠	貝肯翠
神根	申根
神根公約	申根公約
福拉爾貝格州	福拉爾貝格邦
禧福	赫瑞福
禾京頓	沃金頓
禾夫斯堡	狼堡
禾獲甸拿	佛伊弗迪納
科倫坡	可倫坡
科布倫茨	科布倫茲
科摩羅	葛摩
科爾切斯特	科赤斯特
科爾多瓦	哥多華
科爾察	科赤
科爾蒂納丹佩佐	柯蒂納戴比索
科特賴克	科特里克
科特迪瓦	象牙海岸
科珀斯克里斯蒂	聖體市
科發	福弗爾
科米訥	科敏
科納克里	柯那克里
科羅拉多斯普林斯	科羅拉多泉
科羅爾	柯羅
科隆群島	加拉巴哥群島
穆希丁	慕尤丁
穆斯佐	穆斯喬
穆爾西亞	莫夕亞
積遜	傑克森
積遜威爾	傑克孫維
突尼斯	突尼西亞
窩咸史杜	沃爾珊斯托
窩咸森林	瓦爾珊森林
窩士打	伍斯特
窩打老	滑鐵盧
端古·賽義德·西拉杰丁	端姑賽西拉如丁
端姑賽義德·西拉杰丁	端姑賽西拉如丁
端姑賽西拉祖丁	端姑賽西拉如丁
符拉迪沃斯托克	海參崴
第尼伯	第聶伯羅
第尼伯彼得羅夫斯克	第聶伯羅彼得羅夫斯克
第比利斯	提比里斯
第聶伯	聶伯
第聶伯羅	聶伯城
第聶伯羅彼得羅夫斯克	聶伯城
策林根	哲林根
米占再納阿比丁	米占·再納·阿比丁
米德爾塞克斯	密德瑟斯
米德爾斯伯勒	米德斯堡
米德爾斯堡	米德斯堡
米德蘭	密德蘭
米杜士堡	米德斯堡
米沙鄢	維薩亞斯
米沙鄢人	維薩亞人
米爾哥羅德	米爾果羅德
米爾豪森	慕豪森
米詹	米占
米詹·扎因·阿比丁	米占·再納·阿比丁
約塞米蒂	優勝美地
約翰內斯堡	約翰尼斯堡
約翰斯頓	強斯頓
約翰斯頓島	強斯頓島
約翰斯頓環礁	強斯頓環礁
約訥河	約納河
約訥省	約納省
約郡	約克郡
納什維爾	納許維爾
納吉布	納吉
納士維	納許維爾
納帕尼	納潘尼
納戈爾諾	納戈爾諾卡拉巴赫
納沙泰爾	紐沙特
納茨福德	納次福
納華拉	納瓦拉
納言	納哈揚
紐卡斯爾	新堡 紐卡索
紐卡素	新堡 紐卡索
紐咸	紐漢
紐瓦克	紐華克
紐英倫	新英格蘭
紐賓士域	新布藍茲維
紐馬赫	諾伊馬克特
純喫茶	純喫茶
索倫托	蘇連多
索爾玆伯里	索爾茲伯里 索茲伯里
索美塞	索美塞特
索韋托	索維托
索馬里	索馬利亞
索馬里蘭	索馬利蘭
累西腓	勒西菲
紹曾德奧克斯	千橡
經濟合作與發展部	經濟合作及發展部
經濟和氣候保護部	經濟事務和氣候行動部
維也納州	維也納邦
維奇	威治
維岡	維根
維希	維琪
維滕貝格	威登堡
維爾京	維京
維爾京群島	維京群島
維爾茨堡	符茲堡
維珍尼亞	維吉尼亞
緬尼吐巴	曼尼托巴
緬尼圖連	馬尼圖林
緬恩斯	美因茲
羅利	羅里
羅安達	魯安達
羅得島	羅德島
羅得西亞	羅德西亞
羅慈地	羅奇代爾
羅索	羅梭
羅訥新堡	隆河新堡
羅訥河	隆河
羅訥省	隆河省
美加華蒂	梅嘉娃蒂
美善同	梅德斯通
美因	美茵
美因茨	美因茲 美茵茲
美巴蒂灘	歡樂暗沙
美度息士	密德瑟斯
美度石士	密德瑟斯
翁布里亞	溫布利亞
翠絲	雀西
老撾	寮國
老撾人民民主共和國	寮人民民主共和國
老撾文	寮文
老撾法國保護國	寮法國保護國
老撾王國	寮王國
老撾語	寮語
考文垂	科芬特里
考納斯	考那斯
耶也	亞雅
耶哈也	亞雅
耶洛奈夫	黃刀鎮
耶羅納夫	黃刀鎮
耶谷	雅柯布
聖伊天	聖德田
聖何塞	聖荷西
聖何西	聖荷西
聖克拉拉	聖塔克拉拉
聖勞倫斯	聖羅倫斯
聖占士	聖詹姆士
聖地亞哥	聖地牙哥
聖基茨和尼維斯	聖克里斯多福及尼維斯
聖多明各	聖多明哥
聖多美和普林西比	聖多美普林西比
聖尤斯特歇斯	聖佑達修斯
聖巴勃羅	聖帕布羅
聖巴泰勒米	聖巴瑟米
聖帕爾滕	聖波爾坦
聖彼得斯	聖彼得
聖文森特和格林納丁斯	聖文森及格瑞那丁
聖海倫娜	聖海蓮娜 聖赫勒拿
聖特賴登	聖楚登
聖珀爾滕	聖波爾坦
聖班納甸奴	聖伯納迪諾
聖皮埃爾	聖皮耶
聖皮埃爾和密克隆	聖皮耶與密克隆
聖盧西亞	聖露西亞
聖羅莎	聖羅沙
聖老楞佐	聖勞倫斯
聖艾蒂安	聖德田
聖菲	聖塔菲 聖非
聖詹姆斯	聖詹姆士
聖貝納迪諾	聖伯納迪諾
聖赫勒拿	聖海蓮娜
聖路易	聖路易斯
聖迭戈	聖地牙哥
聖達菲	聖塔菲
聖馬力諾	聖馬利諾
聖馬特奧	聖馬刁
聯福	倫弗魯
聯邦信息處理標准	聯邦資料處理標準
肯尼亞	肯亞
胡列治	伍利奇
興都教	印度教
舍伯恩	社本
舒梨	薩里
般尼	班來
般尼茅夫	伯恩茅斯
艾伯塔	亞伯達
艾哈邁德	阿末
艾奧瓦	愛荷華
艾恩德霍芬	恩荷芬
艾斯美	艾厄士米爾
艾爾姆胡爾特	阿姆胡特
艾瑟爾	愛塞
艾肯礁	義淨礁
艾薩	伊薩
艾麗斯斯普林斯	愛麗斯泉
芒廷維尤	山景城
芒特巴克	白加山
芒特甘比爾	甘比爾山
芒特艾薩	伊薩山
芬士巴利	芬斯伯里
芬斯伯雷	芬斯伯里
苗頓	米爾頓
英倫海峽	英吉利海峽
英戈爾施塔特	因戈施塔特
英皇佐治廣場	喬治王廣場
英皇十字	國王十字
英聯邦	大英國協
茨欣瓦利	茲辛瓦利
茨維考	茲威考
茲維考	茲威考
茲錫	奇西克
茹埃萊圖爾	茹埃萊都爾
荷伯特	荷巴特
荷屬安的列斯	荷屬安地列斯
荷爾斯泰因	霍爾斯坦
荷甫	霍夫
荷里活	好萊塢
荷頓	哈爾頓
莫哈末	穆罕默德
莫士比	摩斯比
莫士比港	摩斯比港
莫德伯里	摩保利
莫桑比克	莫三比克
莫爾文	茂路凡
莫爾斯比	摩斯比
莫爾斯比港	摩斯比港
莫策爾	摩策爾
莫羅尼	莫洛尼
莫西亞	莫夕亞
莫迪礁	康西暗沙
莫道克	梅鐸
莫雷阿島	茉莉亞島
華亞度列	瓦拉多利德
華倫	沃倫
華倫西亞	瓦倫西亞
華加華加	沃加沃加
華合	瓦哈
華斯卡拿	瓦斯卡納
華杜茲	瓦都茲
華素爾	沃索爾
華隆	瓦隆
華隆尼亞	瓦隆尼亞
菲尼克斯	鳳凰城
菲尼克斯群島	鳳凰群島
菲希特爾山	費希特山
菲沙	弗雷澤
菲爾特	福爾特
菲瑟涅	弗雷西內
萊斯沃斯	列斯伏斯
萊普州	萊普邦
萊法州	萊法邦
萊波薩維齊	萊波薩維奇
萊特島	雷伊泰島
萊特灣	雷伊泰島 雷伊泰灣
萊特省	雷伊泰省
萊索托	賴索托
萊茵蘭	萊因蘭
萊蒙格羅韋	檸檬林
萊西訥	列辛
萌島	曼島
萬·阿齐扎	旺阿芝莎
萬年煙礁	潭門礁
萬茂	蒙茅斯
萬象	永珍
落基	落磯
葉士域治	伊普斯威奇
葉海亞	亞雅
蒂特里加利	茶樹涌
蒂羅爾	提洛
蒂羅爾州	提洛邦
蒂賓根	圖賓根
蒂頓	提頓
蒙彼利埃	蒙佩利爾 蒙特佩利爾
蒙彼利埃	蒙皮立
蒙得維的亞	蒙特維多
蒙特利爾	蒙特婁
蒙特塞拉特	蒙哲臘
蒙特雷	蒙特瑞
蒲福	博福爾
蓋特威克	蓋威克
蓋茨黑德	蓋茲赫德
薛鄧咸	錫德納姆
薩克拉門托	沙加緬度
薩克森州	薩克森邦
薩安州	薩安邦
薩巴	荷屬沙巴
薩拉戈薩	沙拉哥薩
薩拉熱窩	塞拉耶佛
薩拉赫丁	沙拉胡丁
薩斯卡渣文	薩斯喀徹溫
薩斯卡通	薩斯喀屯
薩斯喀徹溫	薩克其萬
薩斯奎漢納	薩斯奎哈納
薩格勒布	札格瑞布
薩爾州	薩爾邦
薩爾布呂肯	薩爾布魯根
薩爾斯堡州	薩爾斯堡邦
薩爾特河	薩特河
薩爾特省	薩特省
薩爾茨堡	薩爾斯堡
薩爾茨堡州	薩爾斯堡邦
薩爾蘭州	薩爾蘭邦
薩瑟克	南華克
薩福克	沙福
薩萊諾	薩雷諾
薩赫勒	薩赫爾
薩那	沙那
薩頓	索頓
薩默塞特	索美塞特
藍色海岸	蔚藍海岸
蘇克雷	蘇克瑞
蘇加諾	蘇卡諾
蘇哈多	蘇哈托
蘇彞士	蘇伊士
蘇彞士運河	蘇伊士運河
蘇必利爾	蘇必略
蘇里南	蘇利南
蘭加士打	蘭卡斯特
蘭喬科爾多瓦	科多瓦牧場
蘭斯	漢斯
蘭秀	拿索
蘭茨胡特	蘭休特
蘭開斯特	蘭卡斯特
處女	維京
處女群島	維京群島
衛氏朝鮮	衞氏朝鮮
衛滿朝鮮	衞滿朝鮮
衡州	漢普
西南非洲	西南非
西哥特	西哥德
西布礁	簸箕礁
西拉杰丁	西拉如丁
西拉祖丁	西拉如丁
西斯凱	希斯凱
西法倫	西伐利亞 西發利亞
西漢姆	西罕
西澳大利亞州	西澳州
西米卡綿	西密卡米恩
西維爾	塞維亞
西谷	塞爾寇克
西里西亞	西利西亞
訥沙托	紐沙特
訥沙泰勒	紐沙特
訥韋爾	尼維爾
設得蘭	昔得蘭 昔德蘭
設德蘭	昔得蘭 昔德蘭
詩貝亞	斯派爾
詹姆士暗沙	曾母暗沙
詹姆斯	詹姆士
諾丁漢	諾丁罕
諾伍德	諾活
諾咸頓	北安普惇
諾域治	諾威治
諾士佛	納次福
諾定咸	諾丁罕
諾曼底	諾曼第
諾活	諾伍德
諾瓦斯科舍	新斯科細亞
諾維薩德	新沙德
諾華斯高沙	新斯科細亞
諾里奇	諾威治
謝潑德	雪柏
謝爾本	社本
謝菲爾德	雪菲爾
謝赫·穆扎法尔	錫慕查化
譚禾夫	譚沃思
讓布盧	戎布魯
豪士羅	豪恩斯洛
貝夫諾格林	貝思納爾綠地
貝夫農綠地	貝思納爾綠地
貝寧	貝南
貝德福德	貝德福
貝洛奧里藏特	美景市
貝洛納	貝隆納
貝爾格萊德	貝爾格勒
貝爾熱拉克	貝傑拉克
貝爾維尤	柏衛
貝爾莫潘	貝爾墨邦
貝爾訥姆	貝爾嫩
貝羅那	貝隆納
貝靈恩	白令根
貢比涅	康比涅
費特咸	費爾特姆
費雷堡	弗萊堡
賈法	惹化
賓士域	布藍茲維
賓夕凡尼亞	賓夕法尼亞
賓茨	賓茲
賓頓	布蘭普頓
賴興瑙	萊赫瑙
賴謝瑙	萊赫瑙
賽夫	賽義夫
賽慕查化	錫慕查化
賽益	薩伊德
賽義德	薩伊德
贊比亞	尚比亞
赫拉克勒斯	海克力斯
赫爾河畔金斯惇	赫爾河畔京斯惇
赫特福德	哈特福 赫瑞福
赫福	哈特福 赫瑞福
赫里福德	赫瑞福
路易咸	路易斯罕
路易港	路易士港
車士打	切斯特
車士打菲特	赤斯特非
車士打郡	柴郡
車特咸	卓特咸
車路士	切爾西
辛菲羅波爾	辛菲洛普 辛費羅波爾
迪克斯邁德	迪克斯木德
迪凱特	第開特
迪勃拉	第巴爾
迪爾多夫	迪爾道夫
迪耶普	第厄普
通托維	湯多威
道森克里克	道森河
道菲	陶菲克
道里	道裡
道里區	道裡區
達勒姆	德罕 達拉謨
達喀爾	達卡
達姆施塔特	達姆城
達格納姆	達根罕
達沃市	納卯市
達爾富爾	達佛
達爾豪斯	戴爾豪斯
達累斯薩拉姆	三蘭港
達豪	達浩
達雅克	達雅
邁亞密	邁阿密
那不勒斯	拿坡里
那慕爾	納木爾
那米比亞	納米比亞
都靈	杜林
鄧寇克	惇克爾克
鄧巴頓	惇巴頓
鄧迪	丹地
釆倫多夫	釆倫道夫
釆蒂涅	策提涅
里士滿	列治文 里奇蒙
里東礁	北安礁
里爾	里耳
里賈納	雷吉納
金奈	欽奈
金寶	坎貝爾
金寶河	坎貝爾河
金巴倫	坎伯蘭 坎布里亞
金斯惇	京斯惇 京斯頓
金斯惇	金石城
金斯頓	京士頓 京斯頓
金沙薩	金夏沙
釣魚台	釣魚臺
釣魚台及其附屬島嶼	釣魚臺列嶼
釣魚島	釣魚臺
釣魚島及其附屬島嶼	釣魚臺列嶼
錦祿	甘露
錫利	夕利
錫巴頓	非百惇
錫根	席根
錫格堡	希格堡
錫格馬林根	西格馬林根
錫瓦塔內霍	芝華塔尼歐
錫耶納	西恩納
錫菲	雪菲爾
錫里斯	席瑞絲
門洛帕克	門洛公園
門興格拉德巴赫	慕森加柏
閃高	錫姆科
開姆尼茨	肯尼茲
閣倫	科克倫
阿什哈巴德	阿什哈巴特
阿什福德	亞士霍
阿什莫爾和卡捷	亞什摩及卡地爾
阿他加馬	亞他加馬
阿伯丁	亞伯丁
阿伯茨福德	亞博斯福
阿克羅蒂里	亞克羅提利
阿克羅蒂里和澤凱利亞	亞克羅提利與德凱利亞
阿克魯帝利	亞克羅提利
阿克魯帝利及德基利亞	亞克羅提利與德凱利亞
阿卜杜勒	阿布都
阿卜杜勒-阿齊玆	阿布都-阿濟茲
阿卜杜勒-阿齊茲	阿布都-阿濟茲
阿卜杜勒·拉希姆	阿都·拉欣
阿卜杜勒·拉扎克	阿都·拉薩
阿卜杜勒·拉赫曼	阿布都拉曼
阿卜杜勒·阿齊玆	阿布都·阿濟茲
阿卜杜勒·阿齊茲	阿布都·阿濟茲
阿卜杜勒·馬利克	阿都馬力
阿卜杜拉	阿布都拉
阿卜杜拉·巴達威	阿布都拉·巴達威
阿卜杜拉·巴達維	阿布都拉·巴達威
阿卜耶伊	艾卜耶
阿基坦	亞奎丹
阿塔卡馬	亞他加馬
阿塞拜疆	亞塞拜然
阿姆哈拉	安哈拉
阿姆霍特	阿姆胡特
阿布·巴卡爾	阿布巴卡
阿布峇卡	阿布巴卡
阿布巴卡爾	阿布巴卡
阿布扎比	阿布達比
阿布賈	阿布加
阿彭策爾	亞本塞
阿德萊得	阿得雷德
阿德萊德	阿得雷德
阿拉伯埃及共和國	埃及阿拉伯共和國
阿拉伯聯合酋長國	阿拉伯聯合大公國
阿拉姆	阿蘭
阿拉梅達	阿拉米達
阿拉貢	亞拉岡
阿斯馬拉	阿斯瑪拉
阿方索克勞迪烏	阿風索克勞迪歐
阿梅爾	阿爾梅勒
阿森松	亞森欣
阿比讓	阿必尚
阿比路	艾比路
阿爾伯克基	阿布奎基
阿爾伯塔	亞伯達
阿爾伯特	艾伯特
阿爾勒	亞爾
阿爾戈納	阿哥納
阿爾派恩	阿爾卑斯
阿爾維	阿威
阿爾薩斯	亞爾薩斯
阿爾費爾德	阿費爾德
阿特沃特	艾特瓦特
阿特蘭大	亞特蘭大
阿玆	阿濟茲
阿玆敏	阿茲敏
阿玆莎	阿芝莎
阿玆蘭	阿茲蘭
阿登	亞爾丁
阿登森林	亞爾丁森林
阿皮亞	阿庇亞
阿省	亞省
阿米代爾	阿密達
阿納海姆	安那翰
阿維尼翁	亞維農
阿聯酋	阿聯
阿育	阿尤布
阿茲莎	阿芝莎
阿訥西	安錫
阿都	阿布都
阿都拉	阿布都拉
阿都拉·巴達威	阿布都拉·巴達威
阿都拉曼	阿布都拉曼
阿都拉欣	阿都·拉欣
阿都拉薩	阿都·拉薩
阿都阿玆	阿布都-阿濟茲
阿都阿玆	阿布都·阿濟茲
阿順礁	海康暗沙
阿馬爾菲	阿瑪菲
阿齊扎	阿芝莎
阿齊玆	阿濟茲
阿齊茲	阿濟茲
陶域	特威德
陶爾哈姆萊茨	哈姆雷特塔
隆達省	倫達省
隱波暗沙	隠波暗沙
雅也	亞雅
雅各布	雅柯布
雅息士	艾塞克斯
雅息特	艾希特
雅溫得	雅恩德
雅爾塔	雅爾達
雅耶	亞雅
雅賓利	阿伯尼
雷伊泰灣	雷伊泰島
雷克瑟姆	雷克斯漢姆
雷克雅未克	雷克雅維克
雷士廉	萊斯里普
雷德伍德城	紅木城
雷德布里奇	紅橋
雷格尼茨河	雷格尼茲河
霍尼亞拉	荷尼阿拉
霍巴特	荷巴特
霍赫斯特拉滕	胡格斯特拉頓
露明	洛蒙
韋克菲爾德	威克菲
韋卓	維特祖治
韋和夫	維特沃斯
韋息士	威塞克斯
韋斯咸	西罕
韋斯特比奇	西灘
韋根	維根
韋爾登拉特	威登拉特
韋爾維耶	弗威耶
韋爾菲克	威維克
韋特史東	威爾德斯通
韋瑟爾	威瑟爾
韋維爾	威埠
韋茨拉爾	威茲拉爾
韓國	南韓
韓國以及朝鮮	南韓以及北韓
韓國及朝鮮	南韓及北韓
韓國同朝鮮	南韓同北韓
韓國和朝鮮	南韓和北韓
韓國科學技朮院	韓國科學技術院
韓國與朝鮮	南韓與北韓
韓方	南韓方面
韓裔	南韓裔
頓涅茨	頓內次
頓涅茨克	頓內次克 頓內茨克
飛嶼	飛瀨
食品和農業部	食品及農業部
香農	夏農
馬丁內斯	馬丁尼茲
馬來西亞總理	馬來西亞首相
馬六甲	麻六甲
馬利蘭	馬里蘭
馬卡迪	馬卡蒂
馬哈蒂爾	馬哈地
馬哈迪	馬哈地
馬塞盧	馬賽魯
馬恩島	曼島
馬拉維	馬拉威
馬提尼克	馬丁尼克
馬斯河	馬士河
馬斯特里赫特	馬斯垂克
馬普托	馬布多
馬末	馬哈茂德
馬朱羅	馬久羅
馬格德堡	馬德堡
馬爾什	馬什
馬爾代夫	馬爾地夫
馬爾凱	馬凱
馬爾默	馬爾摩
馬耳他	馬爾他
馬薩諸塞	麻薩諸塞
馬薩諸塞州	麻薩諸塞州
馬那瓜	馬納瓜
馬里亞納	馬利安納
馬里共和國	馬利共和國
馬魯古	摩鹿加
驕寧咸	吉林漢姆
高活	科爾伍德
高車士打	科赤斯特
高雲地利	科芬特里
魏爾堡	威爾堡
魏瑪	威瑪
魯昂	盧昂
魯梅爾斯堡	魯梅斯堡
鮑里斯皮爾	波里斯皮爾
鯨灣港	華維斯灣
鴉蘭	阿倫
鴨巴甸	亞伯丁
麥克默里	麥克墨雷
麥吉爾	麥基爾
麥梅利	麥克墨雷
麥納麥	麥納瑪
麥考瑞	麥覺理
麻省	麻薩諸塞州
黑塞哥維那	赫塞哥維納
黑山	蒙特內哥羅
黑林山	黑森林
黑森州	黑森邦
黑池	黑潭
黑爾舍姆	海爾斯罕
黑爾訥	赫內
默塞德	美熹德
黨近	鄧肯
