128位	128位元
12位	12位元
16位	16位元
18位	18位元
1型糖尿病	第1型糖尿病
2009年H1N1流感大流行	2009年H1N1新型流感疫情
2009年人類豬型流感疫情	2009年H1N1新型流感疫情
2019冠狀病毒疾病	嚴重特殊傳染性肺炎
2019冠狀病毒病	嚴重特殊傳染性肺炎
24位	24位元
2型糖尿病	第2型糖尿病
31位	31位元
32位	32位元
36位	36位元
48位	48位元
4位	4位元
60位	60位元
64位	64位元
80位	80位元
8位	8位元
A盤	本機磁碟(A)
A磁碟機	本機磁碟(A)
A群流腦	流行性腦脊髓膜炎（A型）
BC范式	BC正規形式
B盤	本機磁碟(B)
B磁碟機	本機磁碟(B)
C盤	本機磁碟(C)
C磁碟機	本機磁碟(C)
C群流腦	流行性腦脊髓膜炎（C型）
DK范式	DK規格化
D盤	本機磁碟(D)
D磁碟機	本機磁碟(D)
E盤	本機磁碟(E)
E磁碟機	本機磁碟(E)
F盤	本機磁碟(F)
F磁碟機	本機磁碟(F)
Google云消息傳遞	Google雲端通訊
Google工具條	Google工具列
Google文檔	Google文件
Google視頻	Google影片
GSM流動	GSM行動
GSM移動	GSM行動
G盤	本機磁碟(G)
G磁碟機	本機磁碟(G)
H盤	本機磁碟(H)
H磁碟機	本機磁碟(H)
I盤	本機磁碟(I)
I磁碟機	本機磁碟(I)
Java的類	Java的類別
Java類	Java類別
J盤	本機磁碟(J)
J磁碟機	本機磁碟(J)
K盤	本機磁碟(K)
K磁碟機	本機磁碟(K)
L盤	本機磁碟(L)
L磁碟機	本機磁碟(L)
M盤	本機磁碟(M)
M磁碟機	本機磁碟(M)
NetBook	小筆電
Northern印跡	北方墨點
N盤	本機磁碟(N)
N磁碟機	本機磁碟(N)
O盤	本機磁碟(O)
O磁碟機	本機磁碟(O)
PN結	PN接面
P盤	本機磁碟(P)
P磁碟機	本機磁碟(P)
Q盤	本機磁碟(Q)
Q磁碟機	本機磁碟(Q)
R盤	本機磁碟(R)
R磁碟機	本機磁碟(R)
SanDisk	新帝
Southern印跡	南方墨點
SQL注入	SQL隱碼攻擊
SQL注入攻擊	SQL隱碼攻擊
Sun微系統	昇陽電腦
S盤	本機磁碟(S)
S磁碟機	本機磁碟(S)
Toll樣受體	類鐸受體
T盤	本機磁碟(T)
T磁碟機	本機磁碟(T)
Ultrabook	超極致筆電
USB手指	USB隨身碟
U盤	USB磁碟機 USB隨身碟 隨身碟
U磁碟機	本機磁碟(U)
V盤	本機磁碟(V)
V磁碟機	本機磁碟(V)
Western印跡	西方墨點
W盤	本機磁碟(W)
W磁碟機	本機磁碟(W)
X盤	本機磁碟(X)
X磁碟機	本機磁碟(X)
X窗口系統	X視窗系統
Y盤	本機磁碟(Y)
Y磁碟機	本機磁碟(Y)
Z盤	本機磁碟(Z)
Z磁碟機	本機磁碟(Z)
μ中微子	緲微中子
μ子	緲子
τ中微子	濤微中子
τ子	陶子
一型糖尿病	第1型糖尿病
一致收斂	均勻收斂
一致有界性原理	均勻有界原理
一致空間	均勻空間
一致范數	均勻範數
一致連續	均勻連續
一致鄰域	均勻鄰域
一補碼	一補數
丁型流感	D型流感
丁型肝炎	D型肝炎
三分律	三一律
三叉搜尋樹	三元搜尋樹
三叉搜索樹	三元搜尋樹
三叉樹	三元樹
三叉鏈表	三元連結串列
三極管	三極體
三維計算機	3D電腦
三維計算機圖形	3D電腦圖形
三維電影	3D電影
三角蛛屬	扇網蛛屬
三酰甘油	三酸甘油酯
上下文切換	上下文交換
上同倫	餘倫
上同調	餘調
上網本	小筆電
上鏈	餘鍵
下划線	底線
下拉列表	下拉式清單 下拉選單
下拉菜單	下拉式選單
不交并	互斥聯集
世界流動通訊大會	世界行動通訊大會
世界移動通信大會	世界行動通訊大會
丘腹蛛屬	菱蛛屬
丙型流感	C型流感
丙型肝炎	C型肝炎
丟失	遺失
並苯	駢苯
並行計算	平行計算
中值定理	均值定理
中國海大銼蛤	大黃狐蛤
中央前回	中央前迴
中央后回	中央後迴
中央後回	中央後迴
中微子	微中子
中心極限定理	中央極限定理
中性粒細胞	嗜中性球
中端	中階
中級	中階
中華石龍尾	紫蘇草
中間件	中介軟體
丰富互聯網應用程序	多樣化網際網路應用程式
丰度	豐度
串口	串列埠 序列埠
串行	序列
串行端口	串列埠 序列埠
串行計算	序列計算
主元	軸元
主存	主記憶體
主引導記錄	主開機紀錄 主開機記錄
主板	主機板
主頁	首頁
乘數表	乘法表
乙型流感	B型流感
乙型肝炎	B型肝炎
乙酰水楊酸	乙醯柳酸
二噁英	戴奧辛
二叉堆	二元堆積
二叉堆積	二元堆積
二叉搜尋樹	二元搜尋樹
二叉搜索樹	二元搜尋樹
二叉樹	二元樹
二叉鏈表	二元連結串列
二型糖尿病	第2型糖尿病
二極管	二極體
二次域	二次體
二甲硝咪唑	待美嘧唑
二維碼	二維條碼
二補碼	二補數
云存儲	雲端儲存
云計算	雲端運算
互余	互餘
互信息	相互資訊
互協方差	交叉共變數
互斥併集	互斥聯集
互素	互質
互聯網	網際網路
互聯網內容供應商	線上內容提供者
互聯網內容提供商	線上內容提供者
互聯網服務供應商	網際網路服務提供者
互聯網服務提供商	網際網路服務提供者
互聯網金鑰交換	網際網路金鑰交換
互變異搆體	互變異構物
互變異構體	互變異構物
亞原子	次原子
交互	互動
交互式	互動式
交叉韌帶	十字韌帶
亥維賽	黑維塞
亮氨酰	白胺醯
亮氨酸	白胺酸
人工智能	人工智慧
人工神經	類神經
人工肺	葉克膜
人機界面	人機介面
人臉識別	臉部辨識
人面辨識	臉部辨識
人類豬型流感	H1N1新型流感
仁蚧科	仁介殼蟲科
仄腹蠟蟬科	小頭飛蝨科
介孔二氧化硅	中孔洞二氧化矽
介孔氧化硅	中孔洞氧化矽
介質	媒介
介質相關接口	媒體相依介面
代數封閉域	代數封閉體
代數無關	代數獨立
代數相關	代數相依
代數閉域	代數閉體
代碼	程式碼 代碼
代碼生成器	碼產生器
代碼頁	內碼表
令牌	權杖
以太網	乙太網 乙太網路
仲碳	二級碳
仲胺	二級胺
仲醇	二級醇
任務切換	工作切換
任務欄	工作列
任務管理器	工作管理員
仿真	模擬
企業移動管理	企業行動管理
伊維菌素	愛滅蟲
伊辛	易辛
休克爾	休克耳
伯克利軟件套件	柏克萊軟體套件
伯努利	白努利
伯碳	一級碳
伯胺	一級胺
伯醇	一級醇
伴性遺傳	性聯遺傳
伴胞	伴細胞
似然	概似
伽羅瓦域	伽羅瓦體
伽馬	伽瑪
位串	位元串
位圖	點陣圖
位操作	位元運算
位模式	位元型樣
位段	位元欄
低清	低畫質
低端	低階
低級	低階
低級	低階 低級
低級編程語言	低階程式語言
低級語言	低階語言
余代數	餘代數
余像	餘像
余單純	餘單純
余因子	餘因子
余核	餘核
余極限	餘極限
余模	餘模
余法叢	餘法叢
余矢	餘矢
余緯度	餘緯度
佛利民	傅利曼
佯謬	悖論
併集	聯集
例程	常式
依存類型	依存型別
依賴類型	依值型別
便攜式	可攜式
便攜式	行動式 攜帶型
便攜版	可攜式版本
俄歇	奧杰
保存	儲存
保安軟件	安全軟體
信噪比	訊雜比
信息	訊息 資訊
信息及通信技朮	資訊及通訊科技
信息學	資訊學
信息安全	資訊保安 資訊安全
信息技朮	資訊科技
信息技術	資訊科技
信息接觸	資訊參與
信息時代	資訊時代
信息物理系統	網宇實體系統
信息產業	資訊工業
信息管理	資訊管理
信息論	資訊理論
信息過載	資訊超載
信號	訊號
信號	訊號 信號
信號識別粒子	訊息確認顆粒
信號識別顆粒	訊息確認顆粒
信號轉導	訊息傳遞
信號量	號誌
信道	通道
修制	修製
修復記錄	恢復記錄
修飾符	修飾詞
個人數碼助理	個人數位助理
個人網	個人區域網路
個木虱科	叉木蝨科
假石柑	假柚葉藤
假石柑屬	假柚葉藤屬
假設檢定	假說檢定
假設檢驗	假說檢定
偏脹蚶	鞋魁蛤
做了功	作了功
做功	作功
做勻速圓周運動	作等速率圓周運動
做勻速直線運動	作等速直線運動
做勻速運動	作等速運動
做正功	作正功
做的功	作的功
做變速圓周運動	作變速率圓周運動
做負功	作負功
偽代碼	虛擬碼
偽狂犬病	假性狂犬病
傅里葉	傅立葉
傘花茉欒藤	繖花菜欒藤
備擇假設	對立假說
傳感	感測
傳感器	感測器
傳短訊	傳簡訊
傳遞	遞移
僅當	唯若
像素	畫素
僞代碼	虛擬碼
優先級	優先順序
優化	最佳化
元分析	統合分析
元數據	元資料 後設資料
元編程	元程式設計 超程式設計
兆字節	百萬位元組
先驗分布	事前分布
先驗概率	事前機率
光學異搆體	光學異構物
光標	游標
光盤	光碟
光盤驅動器	光碟機
光網絡終端	光纖網路終端
光縴分布式數據接口	光纖分散式資料介面
光纖分散式數據介面	光纖分散式資料介面
光面內質網	平滑內質網
光驅	光碟機
克利福德	克里福
克里斯托費爾	克里斯多福
克隆	複製
免提	擴音
入門系統	入口網站
入門網站	入口網站
內存	記憶體
內存泄漏	記憶體漏失
內容分發網絡	內容傳遞網路
內容可尋址存儲器	可定址內容記憶體
內核	核心
內窺鏡	內視鏡
內置	內建
內聯	行內
內聯函數	行內函數
內聯網	內部網路
內部網	內部網路
內部網絡	內部網路
全局	全域 全域性
全局唯一標識分區表	GUID磁碟分割表
全屏	全螢幕
全屏幕	全螢幕
全屏幕手機	全螢幕手機
全息	全像
全球流動通訊系統協會	全球行動通訊系統協會
全球移動通信系統協會	全球行動通訊系統協會
全球變暖	全球暖化
全細胞百白破疫苗	白喉破傷風全細胞性百日咳混合疫苗
全角	全形
全面屏手機	全螢幕手機
兩棲綱	兩生綱
八叉樹	八元樹
公共陸基移動網	公用陸上行動網路
公地流動網路	公用陸上行動網路
共享文件夾	共用資料夾
共享軟件	共享軟體
共制	共製
共用	共享
共質體途徑	原生質體內路徑
共質體運輸	原生質體內運輸
典型群	古典群
兼容	相容
冒泡排序	氣泡排序 泡沫排序
冷聚變	冷融合
准周期	準週期
凝聚態	凝聚體
几率	機率
凱氏帶	卡氏帶
函數	函式
函數式編程	函式語言程式設計 函數語言程式設計
函數編程語言	函式程式語言
刀片服務器	刀鋒伺服器
分佈	分布
分佈式	分散式
分區	分割區 分割槽
分卷壓縮	分割壓縮
分圓域	分圓體
分層樹形視圖	多層次樹狀介面
分層視圖	多層次樹狀介面
分布式	分散式
分形	碎形
分析器	剖析器
分組交換	封包交換
分組密碼	區塊加密法
分裂域	分裂體
分辨率	解析度
分配單元	單位配置
切倫科夫	契忍可夫
切叢	切線束
切比雪夫	柴比雪夫
切連科夫	契忍可夫
判據	準則
別搆	異位
利他林	利他能
到達域	對應域
制絨	製絨
制霜	製霜
刷新	重新整理
刷新率	重新整理頻率
刺渦蛛	棘渦蛛
刺突蛋白	棘蛋白
刺針	刺胳針
刻錄	燒錄
前向糾錯	正向錯誤校正
前向鏈接	正向鏈結
前導鏈	領先股
前綴	字首
剖宮	剖腹
剪切	剪下
剪應力	切應力
剪貼板	剪貼簿
副甲狀腺激素	副甲狀腺素
創建	建立
劉維爾	萊歐維爾
劉維爾定理	劉維定理
劍蟶屬	刀蟶屬
功能手機	功能型手機
功能電話	功能型手機
加強針	加強劑
加載	載入
助記符	輔助記憶碼
勒夏特列	勒沙特列
勒讓德	勒壤得
勒讓德變換	勒壤得轉換
動力系統	動態系統
動態綁定	動態繫結
動態編碼率	變動位元速率
動態類型	動態型別
勢能	位能
勻速圓周運動	等速率圓周運動
勻速直線運動	等速直線運動
勻速運動	等速運動
勾股定理	畢氏定理
勾股數	畢氏三元數
化學親合勢	化學親和力
化學親和勢	化學親和力
北方印跡	北方墨點
匯編	組譯
匯編語言	組合語言
區域網絡	區域網路
區塊鏈接	區塊鏈結
千層樹	白千層屬
千年健屬	扁葉芋屬
升華	昇華
半角	半形
協作	協同運作
協方差	共變異數
協議	協定
南方印跡	南方墨點
博客	部落格
博雷爾	鮑萊耳
卟啉	紫質
占位符	預留位置
卡那霉素	康黴素
印度簕竹	茨竹
印記	銘印
印跡	墨點
即插即用	隨插即用
卵泡	濾泡
卷積	摺積
卷象科	捲葉象鼻蟲科
卸載	解除安裝
原代碼	原始碼
原發性主動運輸	初級主動運輸
去甲腎上腺素	正腎上腺素
參數	引數
參數列表	參數列
參數表	參數列
參數設置	偏好設定
叉舌蟾科	叉舌蛙科
反碼	一補數
反規范化	解除規格化
反鏈接	反鏈結
反饋	回饋
叔碳	三級碳
叔胺	三級胺
叔醇	三級醇
句柄	控制代碼
叩甲	叩頭蟲
只寫	唯寫
只寫存儲器	唯寫記憶體
只讀	唯讀
只讀存儲器	唯讀記憶體
可執行文件	可執行檔
可擴展	可延伸
可擴展商業報告語言	可延伸商用報告語言
可擴展固件接口	可延伸韌體介面
可擴展置標語言	可延伸標示語言
可攜式軟件	可攜式軟體
可移動	抽取式
可移植文檔格式	可攜式文件格式
可編程	可程式化
可視化	視覺化
可變碼率	變動位元速率
可逆元	可逆元素
台式機	桌上型電腦
台灣千年健	基隆扁葉芋
台灣電鰩	臺灣電鱝
史丹福	史丹佛
右矢	括量
合力	凈力
合外力	凈外力
吉丁科	吉丁蟲科
吉字節	吉位元組
吉比特以太網	十億位元乙太網路
同中子異荷素	同中素
同分異搆體	同分異構物
同分異構體	同分異構物
同旁內角	同側內角
同旁外角	同側外角
同量異位素	同量素
后台流量	背景流量
后台運行	背景執行
后綴	字尾
后隨鏈	延遲股
后驗分布	事後分布
后驗概率	事後機率
向導	精靈
呋喃唑酮	富來頓
呋喃它酮	富來他頓
周期	週期
周期蛋白	週期素
呼出	撥出
呼叫轉移	來電轉駁
命令式編程	指令式程式設計
命令行	命令列
命令鏈接	命令鏈結
命名空間	名稱空間
哈勃	哈伯
哈希	雜湊
哈龍	海龍
哌嗪	匹配拉淨
哮喘	氣喘
唯一性定理	唯一定理
商業模型	商業模式
啟動引導程序	啟動載入程式
啟動欄	啟動列
啟動盤	啟動磁碟
啟動轉換	啟動切換
啫喱豆	雷根糖
喜蟱蛛屬	菲蛛屬
喜鹽草	卵葉鹽藻
喬布斯	賈伯斯
單位元	單位元素
單元格	儲存格
單參函數	一元函式
單李群	單純李氏群
單核白血球	單核球
單核細胞	單核球
單片機	單晶片 微控制器
單純形	單體
單純復形	單體複形
單群	單純群
單通道	單連結
單選按鈕	無線電鈕
單點登錄	單一登入
嗜中性顆粒白血球	嗜中性球
嗜堿性粒細胞	嗜鹼性球
嗜曙紅顆粒白血球	嗜酸性球
嗜酸性粒細胞	嗜酸性球
嗜鹼顆粒白血球	嗜鹼性球
嘉氏帶	卡氏帶
噪聲	雜訊
嚴重急性呼吸系統綜合徵冠狀病毒2	嚴重急性呼吸道症候群冠狀病毒2型
嚴重急性呼吸系統綜合症	嚴重急性呼吸道症候群
嚴重急性呼吸綜合徵冠狀病毒2	嚴重急性呼吸道症候群冠狀病毒2型
嚴重急性呼吸綜合症冠狀病毒2型	嚴重急性呼吸道症候群冠狀病毒2型
嚴重急性呼吸道綜合徵	嚴重急性呼吸道症候群
四叉樹	四元樹
四咪唑	左右四美素
回復	回覆
回收站	資源回收筒
回旋加速器	迴旋加速器
回歸	迴歸
回聲	回音
回調	回呼 回撥
回車符	回車字元
回車鍵	確認鍵
因果推斷	因果推論
因特網密鑰交換	網際網路金鑰交換
因變量	應變數
固件	韌體
固定碼率	固定位元速率
固實壓縮	結實壓縮
固有時	原時
固體物理學	固態物理學
園蛛科	金蛛科
圖像	影象
圖像文件	圖檔
圖庫	相簿
圖形學	圖學
圖形用戶界面	圖形化使用者介面
圖形計算器	繪圖計算機
圖標	圖示
圖片查看器	圖片檢視器
在線	線上
在線視頻	網路影片
地址	位址
地址	地址 位址
地址列	網址列
地址欄	位址列 網址列
地面廣播	無線廣播
地面電視	無線電視
坍縮	塌縮
坡印亭	坡印廷
垂體	腦垂腺
埃姆斯試驗	艾美氏試驗
埃爾德什	艾狄胥
城域網	都會網路
域擴張	體擴張
域論	體論
基因敲除	基因剔除
基因表達	基因表現
基域	基體
基帶	基頻
基於原型的編程	原型程式設計
基於類	類別為基
基於類的編程	類別為基的程式設計
基爾霍夫	克希荷夫
基質	受質
基質水平燐酸化	受質級燐酸化
基類	基礎類別
基類型	基本類型
基體分離	間質隔離
堆排序	堆積排序
堆棧	堆疊
堆棧幀	堆疊框
堆疊幀	堆疊框
堯字節	佑位元組
場效應管	場效電晶體
塑料	塑膠
增強子	強化子
增強現實	擴增實境
壁紙	桌布
壁紙	桌布 壁紙
壓強	壓力
壓縮包	壓縮檔
壞道	壞軌
外泌汗腺	滲泌汗腺
外置	外接
外置硬盤	外接硬碟
外鍵	外來鍵
多主體系統	多代理系統
多任務	多工
多元變量分析	多變量分析
多元變量統計	多變量統計
多元變量統計分析	多變量統計分析
多媒體短訊	多媒體簡訊
多宿主	內送流量備援容錯機制
多態	多型
多拉菌素	多滅蟲
多普勒	都卜勒
多樣化互聯網應用程式	多樣化網際網路應用程式
多線程	多執行緒
多西環素	去氧羥四環黴素
多項式增長	多項式成長
多頻道網絡	多頻道聯播網
大型機	大型電腦
大數定律	大數法則
大桉	玫瑰桉
大爆炸	大霹靂
大環內酯	巨環內酯
大統一理論	大一統理論
大菜	洋菜
大葉慈	梁山慈
天使綜合症	安格曼症候群
天冬氨酸	天門冬胺酸
天冬酰胺	天門冬醯胺
太字節	兆位元組
太陽電腦	昇陽電腦
夫琅禾費衍射	夫朗和斐繞射
奇點	奇異點
套接字	通訊端
套接層	通訊層
奧本海默	歐本海默
威滕	維騰
威耳孫	威爾森
嫵蛛科	渦蛛科
子例程	次常式
子域	子體
子網	子網路
子網掩碼	子網路遮罩
子網絡	子網路
子網絡遮罩	子網路遮罩
字庫	字型檔
字段	欄位
字符	字元
字符串	字串
字符打印機	字元列印機
字符生成器	字元產生器
字符集	字符集
字節	位元組
字體	字型
存儲	儲存
存儲卡	記憶卡
存儲器	記憶體
存儲程序	儲存程序
存儲芯片	記憶晶片
存盤	存檔
孝順竹	蓬萊竹
季碳	四級碳
季銨	四級銨
守護進程	守護行程
安全套接層	安全通訊協定
安全軟件	安全軟體
安姆氏試驗	艾美氏試驗
安格曼綜合徵	安格曼症候群
安裝包	安裝套件
宏	宏 巨集
宏內核	單核心
宏塊	大區塊
宏病毒	巨集病毒
宏觀經濟	總體經濟
宏觀量	巨觀量
官能團	官能基
定位框	定位域
定制	客製化
室房間隔缺損	心室中隔缺損
室間隔缺損	心室中隔缺損
寄存	代管
寄存器	暫存器
密碼認證協議	通行碼鑑別協定
密鑰	金鑰
富亮氨酸重復	多白胺酸重複
富白氨酸重複	多白胺酸重複
察卡夫	查加夫
實例	例項 實例
實封閉域	實封閉體
實模式	真實模式
實軸	實數軸
實閉域	實閉體
寨卡病毒	茲卡病毒
審核	稽核
審覈	稽覈
寫保護	防寫
寬屏	寬螢幕
寬屏幕	寬螢幕
寬帶	寬頻
尋址	定址
尋址模式	定址模式
對乙酰氨基酚	乙醯胺酚
對立假設	對立假說
對話框	對話方塊
對象	物件
對象	物件 對象
導入	匯入
導出	匯出
導出代數	導來代數
導出函子	導來函子
導聯	導程
導航條	導覽列
導集	導來集
小帽桉	脂桉
小蕈甲	小蕈蟲
尖尾芋	尖尾姑婆芋
尼氏體	尼斯小體
尾注	章節附註
尾部遞歸	尾端遞迴
局域網	區域網 區域網路
局部	區域性
局部域	局部體
居里	居禮
屏幕	螢幕
屏幕保護程序	螢幕保護裝置
屏蔽	封鎖 遮蔽
層次結搆	階層
岩芋屬	目賊芋屬
崖角藤屬	利牟芋屬
嵌套	巢狀
嵴	皺褶
工作組	工作群組
工具欄	工具列
左矢	包量
己型肝炎	F型肝炎
布儒斯特角	布魯斯特角
布拉維	布拉菲
布拉開線系	布拉克系
布氏泛樹蛙	布氏樹蛙
布氏蚶	布氏魁蛤
布爾	布林
布爾邏輯	布林運算
布賴特	布萊特
布里淵	布里元
帕金森病	帕金森氏症
帕雷托	柏拉圖
帖子	貼文
帶圈字符	圍繞字元
帶寬	頻寬
常染色體	體染色體
常量	常數
幀	影格
幀同步	影格同步化
幀指針	影格指標
幀率	影格率
幫助文檔	說明文件
幫助與支持	說明與支援
干姜	乾薑
平均碼率	平均位元速率
平均自由程	平均自由徑
并七苯	駢七苯
并五苯	駢五苯
并六苯	駢六苯
并四苯	駢四苯
并發	並行
并發計算	並行計算
并苯	駢苯
并行	並列
并行端口	並列埠
并行計算	平行計算
并集	聯集
幺元素	么元素
幺半	么半
幺正	么正
幾率	機率
底物	受質
底物水平燐酸化	受質級燐酸化
庚型肝炎	G型肝炎
庫普弗細胞	庫佛氏細胞
康復治療	職能治療
康復醫學	復健醫學
廣告位	廣告區
廣域網	廣域網路
廣葉桉	山藍桉
弔絲球竹	南洋竹
引力波	重力波
引導	啟動
引導程序	載入程式
引物	引子
引用	參照
弗廖羅夫	佛雷洛夫
弗羅貝尼烏斯	弗比尼斯
弗蘭克	法蘭克
弗里德曼	傅利曼 傅里德曼
弱電相互作用	電弱交互作用
弱類型	弱型別
強力霉素	去氧羥四環黴素
強生	嬌生
強直性脊柱炎	僵直性脊椎炎
強類型	強型別
彈出窗口	彈出式視窗
彈式熱量計	彈卡計
彈式量熱器	彈卡計
彙編	彙編 組譯
彙編語言	組合語言
彩信	多媒體簡訊
彭羅斯	潘洛斯
影像端子	視訊連接頭
影像記憶體	視訊記憶體
影像輸出	視訊輸出
影片檔	視訊檔
影片流	影片串流
影音流	影音串流
後綴	字尾
後驗分布	事後分布
後驗概率	事後機率
復代數	複代數
復值	複值
復共軛	複共軛
復几何	複幾何
復印	影印
復可微	複可微
復合物	錯合物
復合粒子	複合粒子
復向量	複向量
復域	複域
復射影	複射影
復平面	複數平面
復形	複形
復指數	複指數
復新翅類	複新翅類
復根	複根
復矩陣	複矩陣
復空間	複空間
復系數	複系數
復結搆	複結構
復線叢	複線叢
復解析	複解析
復變量	複變數
復選按鈕	核取按鈕
復選框	核取方塊
復配邊	複配邊
復雜度類	複雜度類別
復雜度類似	複雜度類似
復雜性類	複雜性類別
復離子	錯離子
循環	迴圈
循環	迴圈 循環
循證	實證
循證實踐	實證應用
循證醫學	實證醫學
微博客	微部落格
微型博客	微型部落格
徵狀	症狀
德維特	德威特
德魯德	德汝德
心房利鈉肽	心房排鈉肽
心房鈉尿肽	心房排鈉肽
心房間隔缺損	心房中隔缺損
心臟超聲波	心臟超音波
必理痛	普拿疼
必理通	普拿疼
忒斯拉	特斯拉
快子	迅子
快捷工具欄	快捷列
快捷方式	捷徑
快捷鍵	快速鍵
性價比	CP值 價效比
性能	效能
性連鎖遺傳	性聯遺傳
恢復光盤	還原光碟
恩諾沙星	恩氟奎林羧酸
情景模式	音訊設定檔
惠更斯原理	惠金斯原理
愛拉托散尼	埃拉托斯特尼
應用程序	應用程式
應用程序接口	應用程式介面
應變量	應變數
戊型肝炎	E型肝炎
我的文檔	我的文件
截取	擷取
截屏	截圖 螢幕擷取
房間隔缺損	心房中隔缺損
扁核木屬	假皂莢屬
扁蠟蟬科	軍配飛蝨科
扇區	磁區
扇角甲科	細櫛角蟲科
手提電腦	筆記型電腦
扎克伯格	祖克柏
扒站	砍站
打印	列印
打印機	印表機
打印預覽	預覽列印
打開	開啟 打開
托管	代管
托管代碼	受控代碼
扭力變矩器	扭矩轉換器
批處理	批次處理
批處理文件	批次檔
批處理程序	批次程式
批量	批次
投擲	丟擲
抗炎	抗發炎
抗驚厥	抗痙攣
拉沙熱	拉薩熱
拉烏爾	拉午耳
拉瓦錫	拉瓦節
拋出	丟擲
拍字節	拍位元組
拐點	反曲點
拒絕服務	阻斷服務
拖拽	拖曳
拷貝	複製
持久性	永續性
指針	指標
按位	按位元
捲積	摺積
捷威	桀威
掃描儀	掃描器
掃雷	踩地雷
排佈	組態
排布	組態
掛斷	結束通話
採樣	取樣
採樣率	取樣率
接入復用器	接取多工器
接入點	存取點
接口	介面
接近傳感器	鄰近感測器
接頭蛋白	轉接蛋白
控件	控制元件 控制項
推送	推播
描述統計	敘述統計
插件	外掛 外掛程式
搆造函數	建構函式
搆造原理	遞建原理
搜索	搜尋
搜索框	搜尋方塊
搜索關鍵字	搜尋鍵碼
摩爾	莫耳
摩爾分數	莫耳分率
撓率	扭率
撤銷	復原
播客	Podcast
操作對象	運算物件
操作數	運算元
操作符	運算子
操作系統	作業系統
擎爪泥甲科	角胸泥蟲科
擬南芥	阿拉伯芥
擬合優度	適合度
擬常染色體區	偽體染色體區
擬步甲科	擬步行蟲科
擴展	擴充 擴充套件
擴展A区	擴充A區
擴展B区	擴充B區
擴展C区	擴充C區
擴展D区	擴充D區
擴展E区	擴充E區
擴展F区	擴充F區
擴展G区	擴充G區
擴展區	擴充區
擴展名	副檔名
擴展漢字	擴充漢字
擴展現實	延展實境
擴張域	擴張體
擴張實境	擴增實境
擺動堿基對	搖擺鹼基對
擺動配對	搖擺配對
攝像放像機	攝錄影機
攝像機	攝錄影機
攝像頭	網路攝影機
攝動	微擾
支持	支援
支持者	支持者
改寫	覆寫
放射技師	醫事放射師
散列	雜湊
整塊性核心	單核心
整體域	大域體
數域	數體
數字	數位
數字	數字 數位
數字化	數位化
數字印刷	數位印刷
數字圖像	數位影像
數字地面電視	數位無線電視
數字媒體	數位媒體
數字廣播	數位廣播
數字模式	數位模式
數字水印	數位浮水印
數字測圖	數位製圖
數字照片	數位相片
數字版權	數位版權
數字發行	數位發行
數字相機	數位相機
數字移動	數位行動
數字簽名	數位簽章
數字視頻	數位影片
數字證書	數位憑證
數字資產	數位資產
數字身份	數位身分
數字電子	數位電子
數字電視	數位電視
數字電路	數位電路
數據	資料
數據中心	資料中心
數據倉庫	資料倉儲
數據包	封包
數據包含	資料包含
數據包括	資料包括
數據執行保護	系統記憶體保護
數據報	資料包
數據報文	資料報
數據市集	資料市集
數據幀	資料框
數據庫	資料庫
數據挖掘	資料探勘
數據捕撈	資料挖掘
數據探勘	資料探勘
數據清洗	資料淨化
數據源	資料來源
數據鏈接	資料鏈結
數據集市	資料市集
數據類型	資料類型
數碼化	數位化
數碼圖像	數位影像
數碼地面電視	數位無線電視
數碼媒體	數位媒體
數碼廣播	數位廣播
數碼影片	數位影片
數碼模式	數位模式
數碼水印	數位浮水印
數碼流動	數位行動
數碼版權	數位版權
數碼發行	數位發行
數碼相機	數位相機
數碼相片	數位相片
數碼簽章	數位簽章
數碼製圖	數位製圖
數碼證書	數位憑證
數碼資產	數位資產
數碼身份	數位身分
數碼電視	數位電視
數組	陣列
數量曲率	純量曲率
文件	檔案
文件主名	主檔名
文件名	檔名
文件名字	檔案名字
文件名稱	檔案名稱
文件命名空間	檔案命名空間
文件夾	資料夾
文件描述符	檔案描述子
文件擴展名	副檔名
文字處理	文書處理
文字處理器	文書處理器
文本	文字
文本文件	文字檔案
文本框	文字方塊
文本編輯器	文字編輯器
文檔	文件
文檔對象模型	文件物件模型
文檔文件	文件檔案
文界面	文介面
斐波納契	費波納契
斐波那契數列	費氏數列
斑木虱	斑木蝨
斑皮桉	斑桉
斑腿泛樹蛙	斑腿樹蛙
斑葉桉	灰桉
斯坦福	史丹佛
斯塔克	史塔克
斯塔爾	史達
斯涅爾	司乃耳
斯涅耳	司乃耳
斯特恩一革拉赫實驗	史頓一加立克實驗
斯特爾	史達
斯特藩	斯特凡
斯盧茨基	史拉斯基
斯諾登	史諾登
方差	變異數
方程	方程式
施圖姆	史特姆
施樂	全錄
施特恩	斯特恩
施瓦玆	施瓦次
旋光異構體	光學異構物
日志	紀錄檔
日曆程序	行事曆程式
易化擴散	促進性擴散
易失性	揮發性
星球屬	有星屬
映射	對映
時分多址	分時多重進接
時分複用	分時多工
時鐘頻率	時脈頻率
晶閘管	閘流體
晶體場	晶場
晶體管	電晶體
智慧	智慧型
智能	智慧 智慧型
智能化	智慧化
智能卡	智慧卡
智能手機	智慧型手機
智能手表	智慧型手錶
智能手錶	智慧型手錶
智能電視	智慧型電視
智能音箱	智慧型喇叭
替米考星	氨基泰黴素
最優化	最佳化
最小二乘	最小平方
最底層派生類	最末層衍生類別
最終用戶	終端使用者
最終用戶許可協議	終端使用者授權協定 終端使用者授權合約
會話	對談
會話劫持	連線劫持
會話標識	交談識別碼
有序域	有序體
有心力	連心力
有損壓縮	失真壓縮 有失真壓縮
有盡不循環小數	有限不循環小數
有盡小數	有限小數
有盡循環小數	有限循環小數
有限域	有限體
服務器	伺服器
服務器消息塊	伺服器訊息區塊
服務器陣列	伺服器陣列
服務框架	服務架構
服務端	伺服器端
朗繆爾	朗繆耳
本地代碼	原生代碼
本地化	在地化
本地的	原生的
本徵函數	固有函數
朱克伯格	祖克柏
李屬	梅屬
李納	黎納
東方長嫵蛛	東亞夜蛛
東方長蟱蛛	東亞夜蛛
析搆	解構
析搆函數	解構函式
析構函數	解構函式
枚舉	列舉
枚舉器	列舉元
枚舉成員	列舉元
果凍豆	雷根糖
柏克萊軟件套件	柏克萊軟體套件
柏金遜症	帕金森氏症
查依釆夫	柴瑟夫
查德威克	查兌克
查戈夫	查加夫
查找	尋找 查詢
查看	檢視
柯弗氏細胞	庫佛氏細胞
柳葉刀	刺胳針
柳葉桉	雪梨藍桉
校園網	校園網路
校園網絡	校園網路
核嬗變	核轉換
核磁共振波譜法	核磁諧振譜學
核磁共振譜學	核磁諧振譜學
核素	核種
核聚變	核融合
核裂變	核分裂
格拉赫	革拉赫
格里夫氏症	葛瑞夫茲氏病
格里斯	革利士
格銳目	格雷姆
框同步化	影格同步化
框圖	方塊圖
框指標	影格指標
桌上電腦	桌上型電腦
桌面型	桌上型
梅塞爾森	梅瑟生
梗死	梗塞
條脊甲	背條蟲
棘層	棘狀層
棣莫弗	棣美弗
楞次	冷次
概率	機率
榛蚶	船魁蛤
構築原理	遞建原理
構造函數	建構函式
樂視云計算	樂視雲計算
標勢	純量勢
標清	標準畫質
標簽頁	分頁
標記語言	標示語言
標識符	識別碼 識別符號
標量	純量
標頭	檔頭
標題欄	標題列
模塊	模組
模式識別	圖型識別
模擬	模擬 類比 類比
模擬廣播	類比廣播
模擬現實	模擬實境
模擬電子	類比電子
模擬電視	類比電視
模擬電路	類比電路
樹狀細胞	樹突細胞
樹突狀細胞	樹突細胞
機器代碼	機器碼
機械碼	機器碼
機頂盒	機上盒
橫屏幕	橫螢幕
橫熒幕	橫螢幕
橫紋蠅獅	橫紋蠅虎
檢驗	檢定
檢驗位	核對位元
檢驗和	核對和
權標	符記
權限	許可權
欠阻尼	次阻尼
歐內斯特	歐尼斯特
正交補	正交補餘
正則表達式	正規表示式
正則語言	正規語言
正態	常態
步甲	步行蟲
死機	宕機 當機
死鎖	死結
殺毒	防毒
比特	位元
比特幣	比特幣
比特率	位元率 位元速率
比特誤碼率	位元錯誤率
毛山豬菜	變葉姬旋花
毛泥甲	長花蚤
毛葉喜鹽草	毛葉鹽藻
毛葉桉	托列里桉
氟甲喹	氟滅菌
氟甲碸霉素	氟甲磺氯黴素
氟苯尼考	氟甲磺氯黴素
氟苯達唑	氟苯並嘧唑氨基甲酸
氦聚變	氦融合
氨基	胺基
氨基酸	胺基酸
氨肽酶	胺肽酶
氨苄青霉素	安比西林
氨酸	胺酸
氫聚變	氫融合
氯喹	氯化奎寧
水制	水製
水印	浮水印
求余	求餘
沃森	華生
沃爾克	沃克
沙哈諾夫	沙卡洛夫
沙士	SARS
沙斯	SARS
沼大蚊	亮大蚊
沼芋屬	水芭蕉屬
泊松	卜瓦松 帕松
法布里	法布立
泡利	包立
泡沫塑料	泡沫塑膠
波分複用	波長分波多工
波矢	波向量
波義耳	波以耳
注冊機	序號產生器
注冊表	登錄檔
泰妙菌素	泰妙素
泰樂菌素	泰黴素
洛倫玆	勞侖茲
洛倫茨	勞侖次
洛埃境	洛以得鏡
洛必達	羅必達
洪德規則	洪德定則
洪特規則	洪德定則
活動體	滋養體
活度因子	活性因子
活度系數	活性係數
活鎖	活結
派生	衍生
派生類	衍生類別
派生類型	衍生類型
流動互聯網	行動網際網路
流動代理	行動代理
流動作業系統	行動作業系統
流動公司	行動公司
流動平台	行動平台
流動廣播	行動廣播
流動性	行動性
流動應用	行動應用
流動支付	行動支付
流動數據	行動資料
流動瀏覽器	行動瀏覽器
流動營辦商	行動業者
流動版	行動版
流動產品	行動產品
流動用戶端	行動用戶端
流動硬碟	行動硬碟
流動程式碼	行動程式碼
流動端	行動端
流動終端	行動終端
流動網絡	行動網路
流動網絡營辦商	行動網路業者
流動裝置	行動裝置
流動資訊器材定義檔	行動資訊裝置設定檔
流動軟件	行動軟體
流動通訊	行動通訊
流動通訊開放制式聯盟	開放行動聯盟
流動電腦	行動電腦
流動電視	行動電視
流動電訊	行動電信
流動電訊營辦商	行動電信業者
流動電話	行動電話
流媒體	串流媒體
流密碼	串流加密法
流水線	管線
流腦	流行性腦脊髓膜炎
浦肯野縴維	浦肯野纖維
浮萍屬	青萍屬
海馬旁回	海馬旁迴
海馬體	海馬迴
消元法	消去法
消去反應	脫去反應
消息	訊息
消息	訊息 消息
消息框	訊息方塊
消息認證碼	訊息鑑別碼
消除反應	脫去反應
液力變矩器	扭矩轉換器
液泡	液胞
深切治療部	加護病房
混合現實	混合實境
添加	新增
清理緩存	清除快取
減毒活	活性減毒
減毒活疫苗	減毒性疫苗
減毒活病毒	減毒性病毒
減活	活性減毒
減活疫苗	減毒性疫苗
減活病毒	減毒性病毒
測序	定序
渲染	彩現
游蛇科	黃頷蛇科
湍流	亂流
湯姆孫	湯姆森
湯姆生	湯姆森
源代碼	原始碼
源文件	原始檔
源碼	原始碼
溢出	溢位
溶組織內阿米巴	痢疾阿米巴
溶酶體	溶體
滅活	不活化
滑塊	滾軸
滾動	捲動
滾動框	捲動方塊
滾動條	捲軸
滾動欄	捲軸
演示文稿	簡報
演示稿	簡報
漢坦病毒	漢他病毒
潰客	劊客
澤字節	皆位元組
澱粉樣物質	類澱粉蛋白
澱粉樣蛋白	類澱粉蛋白
激光	鐳射 雷射
激光視盤	雷射影碟
激動劑	促效劑
激微波	邁射
激活	啟用 活化
激活函數	啟用功能
激活劑	活化劑
瀏覽框	瀏覽域
火制	火製
炮制	炮製
無偏	不偏
無損	無失真
無損壓縮	無失真壓縮
無盡不循環小數	無限不循環小數
無盡小數	無限小數
無盡循環小數	無限循環小數
無細胞百白破疫苗	白喉破傷風非細胞性百日咳混合疫苗
煙酰胺	菸鹼醯胺
煙酸	菸鹼酸
照片	相片
熒幕	螢幕
熒幕保護裝置	螢幕保護裝置
熒幕擷取	螢幕擷取
熱亞海芋	蘭嶼姑婆芋
營運總監	營運長
營銷	行銷
燭大蚊	錐大蚊
爬行綱	爬蟲綱
爬行類	爬蟲類
父類	父類別
版權	著作權
牙甲科	牙蟲科
牡竹屬	麻竹屬
物理內存	實體記憶體
物理地址	實體位址 實體地址
物理層	實體層
物質的量	物量
特麗瓏	特麗霓虹
犁頭尖	土半夏
犁頭尖屬	土半夏屬
狀態欄	狀態列
狄默夫	棣美弗
獅子尾	香港針房藤
獐牙菜屬	當藥屬
獲取	取得
玉山竹	玉山箭竹
玉山竹屬	玉山箭竹屬
王氏原指樹蛙	王氏樹蛙
玩家國度	玩家共和國
玻恩	波恩
玻爾	波耳
玻爾玆曼	波茲曼
玻爾玆曼常數	波茲曼常數
玻爾磁子	波耳磁元
珀羅	培若
班納杜	普拿疼
球蛛屬	姬蛛屬
球蛛科	姬蛛科
琉球原指樹蛙	艾氏樹蛙
瑞利	瑞立
瑞鳳玉	多角仙人球
瑪莉	瑪麗
瑪莉亞	瑪麗亞
瓊脂	洋菜
瓢甲科	瓢蟲科
瓢蠟蟬科	圓飛蝨科
甘油三酸酯	三酸甘油酯
生發中心	生髮中心
生精小管	細精管
生長抑素	體抑素
產品密鑰	產品金鑰
用戶	使用者
用戶介面	使用者介面
用戶名	使用者名稱
用戶框	使用者方塊
用戶生成內容	使用者供應內容
用戶界面	使用者介面
用戶組	使用者群組
用戶頁	使用者頁面
甲型H1N1流感	H1N1新型流感
甲型流感	A型流感
甲型肝炎	A型肝炎
甲殼素	幾丁質
甲狀旁腺	副甲狀腺
甲狀旁腺激素	副甲狀腺素
界面	介面
畢奧	必歐
畢氏數	畢氏三元數
異亮氨酸	異白胺酸
異常處理	例外處理
異或	互斥或
異搆體	異構物
異方差	異質變異數
異構體	異構物
異步	非同步
異白氨酸	異白胺酸
異養	異營
當且僅當	若且唯若
當前版本	目前版本
疑難解答	疑難排解
痴呆症	失智症
瘋牛病	狂牛症
瘋牛症	狂牛症
瘦木虱屬	中尾突木蝨屬
登錄	登入
發佈	釋出
發短信	傳簡訊
發短訊	傳簡訊
發簡訊	傳簡訊
發送	傳送
白氨酸	白胺酸
白氨醯	白胺醯
白破疫苗	白喉破傷風混合疫苗
白細胞	白血球
百度云計算	百度雲計算
百白破	白喉破傷風百日咳
百白破三聯	白喉破傷風百日咳混合
百金花屬	百金屬
皮埃爾	皮耶
皮爾遜	皮爾森
皮蠹	鰹節蟲
監控	監視
盤片	碟片
盤符	磁碟機代號
盧瑟福	拉塞福
目標代碼	目的碼
目標用戶	目標使用者
目標碼	目的碼
目標軟件	目標軟體
目標集	目標集合
相互作用	交互作用
相冊	相簿
相機手機	照相手機
相消干涉	破壞性干涉
相長干涉	建設性干涉
盾蚧科	盾介殼蟲科
盾蝽科	盾背蝽科
矢勢	向量勢
矢量	向量
矢量圖形	向量圖形
知識產權	智慧財產權
短信	簡訊
短視頻	短影音
短訊	簡訊
石柑子	柚葉藤
石柑屬	柚葉藤屬
石柑族	柚葉藤族
砹	砈 砈
硅	矽
硅藻	矽藻
硝酸甘油	硝化甘油
硝酸甘油炸藥	矽藻土炸藥
硬件	硬體
硬盤	硬碟
硬盤陣列	硬碟陣列
硬盤驅動器	硬碟機
硬編碼	寫死
碧眼原指樹蛙	碧眼樹蛙
碼分多址	分碼多重進接
碼率	位元速率
磁共振成像	磁共振造影
磁力共振掃描	磁共振造影
磁疇	磁域
磁盤	磁碟
磁盤碎片整理	磁碟重組
磁盤碎片整理程序	磁碟重組工具
磁盤陣列	磁碟陣列
磁盤驅動器	磁碟機
磁道	磁軌
磁頭划碰	磁頭損壞
示例	範例
社交媒體	社群媒體
社交網站	社群網站
社交網絡	社群網路
社區	社羣 社區
社會媒體	社群媒體
祝蛾	折角蛾
神曲	神麴
神經氨酸	神經胺酸
神經症	精神官能症
科普蘭	克柏蘭
科赫法則	柯霍氏法則
移動互聯網	行動網際網路
移動代理	行動代理
移動代碼	行動程式碼
移動信息設備配置文件	行動資訊裝置設定檔
移動內容管理	行動內容管理
移動公司	行動公司
移動客戶端	行動用戶端
移動平台	行動平台
移動廣播	行動廣播
移動性	行動性
移動應用	行動應用
移動應用管理	行動應用管理
移動操作系統	行動作業系統
移動支付	行動支付
移動數據	行動資料
移動瀏覽器	行動瀏覽器
移動版	行動版
移動產品	行動產品
移動硬盤	行動硬碟
移動端	行動端
移動終端	行動終端
移動網絡	行動網路
移動網絡運營商	行動網路業者
移動聯網設備	行動網路裝置
移動計算機	行動電腦
移動設備	行動裝置
移動設備管理	行動裝置管理
移動資料	行動資料
移動軟件	行動軟體
移動通信	行動通訊
移動運營商	行動業者
移動電信	行動電信
移動電信運營商	行動電信業者
移動電源	行動電源
移動電視	行動電視
移動電話	行動電話
稀有氣體	惰性氣體
稈柄	莖脛
程序	程式
程序員	程式設計師
程序編寫員	程式設計師
程序設計	程式設計
種群	族群
穀氨	麩胺
穀氨酰胺	麩醯胺酸
穀氨酸	麩胺酸
穀草轉胺酶	麩草轉胺酶
穀蛾科	蕈蛾科
穆斯堡爾	梅斯堡
積矩	積動差
穎蠟蟬科	小頭飛蝨科
空串	空字串
空分多址	分空間多重進接
空分複用	空間多工
空列表	空串列
空穴	電洞
窄帶	窄頻
窗口	視窗
窗口管理器	視窗管理員
窗大蚊	平大蚊
窗體	表單
立體異搆體	立體異構物
立體異構體	立體異構物
站點標識按鈕	網站識別鈕
端口	埠
端口轉發	通訊埠轉發
笛卡爾	笛卡兒
第一型錯誤	型一錯誤
第一范式	第一規格化
第一類錯誤	型一錯誤
第三范式	第三正規化
第二型錯誤	型二錯誤
第二范式	第二正規化
第二類錯誤	型二錯誤
第五范式	第五規格化
第六范式	第六規格化
第四范式	第四規格化
筆記本電腦	筆記型電腦 膝上型電腦
等勢線	等位線
等離子態	電漿態
等離子體	電漿 電漿體
答復	答覆
算子	運算元
算朮平方根	主平方根
算法	演算法
範式	正規化
簕竹屬	蓬萊竹屬
簽名	簽章
米篩竹	八芝蘭竹
粉虱	粉蝨
粒細胞	顆粒球
粗面內質網	粗糙內質網
粘康酸	黏康酸
粘貼	貼上
粘貼	貼上 粘貼
粘連	沾黏
粲夸克	魅夸克
粲數	魅數
精神分裂症	思覺失調症
糖原貯積症	肝糖儲積症
糖基	醣苷基
糖基化	醣基化
糖異生	糖質新生
糖酵解	糖解
系數	係數
系統發生學	種系發生學
系統盤	系統磁碟
系統磁碟機	系統磁碟
系統綜述	系統性回顧
系統脫敏	系統減敏感
糾纏	纏結
約數	因數
約束聚變	局限融合
紅千層屬	瓶刷子樹屬
紅心大戰	傷心小棧
紅細胞	紅血球
納米	奈米
素元	質元素
素因子	質因子
素因數	質因數
素性	質性
素性測試	質數測試
素數	質數
素理想	質理想
素環	質環
索尼流動	索尼行動
索尼流動通訊	索尼行動通訊
索尼移動	索尼行動
索尼移動通信	索尼行動通訊
紫萍屬	浮萍屬
細胞器	胞器
終結器	終端子
組件	元件
組合框	組合方塊
組提示	群組提示
組氨酸	組胺酸
組群	群組
組胺	組織胺
組蛋白	組織蛋白
組鏈接	塊鏈結
結合存儲	可定址內容記憶體
結合疫苗	混合疫苗
結實腰蟱蛛	膝形渦蛛
結束應用程序	結束應用程式
絡合物	錯合物
絡離子	錯離子
統一渲染架搆	統一著色器架構
統計功效	檢定力
統計噪聲	統計雜訊
統計推斷	統計推論
綁定	繫結
經典	古典
綜合徵	症候群
綜合症	症候群
綠色軟件	可攜式軟體
綠蘿	黃金葛
維他命	維生素
維恩	維因
維蒂希	威悌
網上欺凌	網路霸凌
網上鄰居	網路上的芳鄰
網卡	網絡卡
網吧	網咖
網景導航者	網景領航員
網格線	格線
網民	網友
網狀數據庫	網狀式資料庫
網盤	網路硬碟
網絡	網路
網絡動畫	網路動畫
網絡攝影機	網路攝影機
網絡欺凌	網路霸凌
網絡漫畫	網路漫畫
網絡營辦商	網路業者
網絡硬盤	網路硬碟
網絡硬碟	網路硬碟
網絡資料庫	網狀式資料庫
網絡購物	網路購物
網絡運營商	網路業者
網誌	部落格
網關	閘道器
網頁快照	頁庫存檔 頁面快取檔
線上影片	網路影片
線形蟲動物門	線形動物門
線性無關	線性獨立
線性相關	線性相依
線程	執行緒
線粒體	粒線體
編程	程式設計
編程范型	程式設計範式
編程語言	程式語言
編輯欄	編輯列
緩存	快取
緩存溢出	緩衝區溢位
緩沖器	緩衝區
緩沖存儲器	快取記憶體
緲中微子	緲微中子
縮小膜殼絛蟲	縮小絛蟲
縮略圖	縮圖
縮略網址	縮網址
縮進	縮排
總線	匯流排
總體	母體
繼承列表	衍化列
繼發性主動運輸	次級主動運輸
纓甲科	櫻毛蕈蟲科
缺省	預設
置信區間	信賴區間
置信水平	信心水準
置標語言	標示語言
羊毛甾醇	羊毛脂固醇
美國在線	美國線上
羥氯喹	羥氯奎寧
翻譯	轉譯
耗散力	耗能力
聚糖	聚醣
聚變反應	融合反應
聯機交易處理	線上異動處理
聯機分析處理	連線分析處理
聯系	聯絡
聯系人	聯絡人
聯繫	聯絡
聯繫歷史	通話記錄
聲卡	音效卡
聲明	宣告
職業治療	職能治療
肉桂醛	桂皮醛
胃食管反流病	胃食道逆流
胞間連絲	原生質絲
胡克	虎克
胰高血糖素	升糖素
能層	動區 動圈
能級	能階
脈蠟蟬科	縞飛蝨科
脊冠葉蟬科	緣脊葉蟬科
脊髓灰質炎	小兒麻痺症
脫機	離線
脫氧	去氧
脫氧土霉素	去氧羥四環黴素
脫氧核糖	去氧核糖
脫氧羥四環黴素	去氧羥四環黴素
脫氫	去氫
脫碘	去碘
脫落酸	離層素
脫輔基酶	去輔基酶
腎單位	腎元
腦下垂體	腦垂腺
腦回	腦迴
腦垂體	腦垂腺
腦橋	橋腦
腦機接口	人機介面
腦退化症	失智症
腳本	指令碼
腳本語言	手稿語言
腳注	註腳
腹胚亞目	抱卵亞目
臉譜	臉書
自動轉屏	自動旋轉螢幕
自回歸	自我迴歸
自守形式	自守式
自定義	自訂
自底向上	由下而上
自相關	自我相關
自述文件	讀我檔案
自養	自營
致電離輻射	游離輻射
臺式機	桌上型電腦
臺灣電鰩	臺灣電鱝
舟蚶	鷹翼魁蛤
航天飛機	太空梭
般若	裝飾仙人球
艾字節	艾位元組
芫菁科	地膽科
芯片	晶片
花尾斜鱗蛇	史丹吉氏斜鱗蛇
花屏	破圖
花葉病毒	鑲嵌病毒
花螢科	菊虎科
苄基	苯甲基
苯並	苯駢
苯二氮䓬	苯二氮平
苯并	苯駢
英偉達	輝達
范型	範式
范德瓦耳斯	凡得瓦
范德華	凡得瓦
范德華力	凡得瓦力
范德華引力	凡得瓦力
范德華方程	凡得瓦方程式
范德華方程式	凡得瓦方程式
范德華鍵	凡得瓦鍵
范托夫	凡特荷夫
范特霍夫	凡特荷夫
茨藻屬	拂尾藻屬
草茨藻	拂尾藻
荷質比	電荷質量比
莫塞萊	莫斯利
菊花鏈接	菊式鏈結
菜單	選單
菜單	選單 菜單
菱蠟蟬科	菱飛蝨科
菲涅耳衍射	菲涅耳繞射
萬維網	全球資訊網
萬維網聯盟	全球資訊網協會
葉甲科	金花蟲科
著作權信息	著作權資訊
葡萄桉	鹽風桉
葬甲科	埋葬蟲科
蒙特卡洛	蒙地卡羅
蒲金耶氏纖維	浦肯野纖維
蒸騰	蒸散
蓋	給呂薩克
蓋斯	赫士
蓋茨	蓋茲
蓋革計數器	蓋格計數器
蓮座蕨	觀音座蓮
薛定諤	薛丁格
薩伐爾	沙伐
薩哈羅夫	沙卡洛夫
薩斯坎德	色斯金
藍子魚	臭肚魚
藍屏	藍色畫面
藍屏死機	藍白當機
藍牙	藍芽
藍畫面死機	藍白當機
藥劑師	藥師
藻百年屬	紫芳草屬
蘇士侃	色斯金
處理函數	處理常式
虛函數	虛擬函式
虛擬內存	虛擬記憶體
虛擬專用網	虛擬私人網路
虛擬機	虛擬機器
虛擬機器	虛擬機器
虛無假設	虛無假說
虛軸	虛數軸
蚜科	常蚜科
蚶屬	魁蛤屬
蚶目	魁蛤目
蚶科	魁蛤科
蛋白同化甾類	同化類固醇
蛋白質組	蛋白質體
蛤莫蛛屬	蛤蟆蛛屬
蜂巢式數據	蜂巢式資料
蜂巢式網絡	蜂巢式網路
蜂窩數據	蜂巢式資料
蜂窩網絡	蜂巢式網路
蜘蛛紙牌	連環新接龍
蟱蛛科	渦蛛科
蠅虎屬	條斑蠅虎屬
血管緊張素	血管收縮素
血紅素	血基質
行動聯網裝置	行動網路裝置
行政總裁	執行長
行程控制表	過程控制段
衍射	繞射
衣原體	披衣菌
衣原體門	披衣菌門
表情包	哏圖
表達式	表示式 運算式
表面皿	錶玻璃
袖蠟蟬科	長翅飛蝨科
裂合酶	解離酶
裂木虱科	錦葵木蝨科
裂解酶	解離酶
補丁	修補程式
補救合成	再利用合成
補救途徑	再利用路徑
補碼	二補數
裴蜀	貝祖
複印	影印
複合物	錯合物
複選按鈕	覈取按鈕
複選框	覈取方塊
複離子	錯離子
西方印跡	西方墨點
西部數據	威騰電子
覆銅板	銅箔基板
規範化	規格化
規范化	規格化
視像會議	視訊會議
視光師	驗光師
視圖	檢視
視杆細胞	視桿細胞
視頻	影片
視頻	影片 視訊
視頻接口	視訊連接頭
視頻文件	視訊檔
視頻文檔	視訊檔案
視頻會議	視訊會議
視頻檔	視訊檔
視頻游戲	電動遊戲
視頻處理器	影像處理器
視頻軌	視訊軌
視頻輸入	視訊輸入
視頻輸出	視訊輸出
視頻通話	視訊通話
解像度	解析度
解引用	解除參照
解釋器	直譯器
解釋型語言	直譯語言
觸屏	觸控螢幕
觸摸	觸控 輕觸
觸摸屏	觸控式螢幕
觸摸板	觸控板
計算機安全	電腦保安
計算機斷層成像	電腦斷層掃描
計算機科學	電腦科學
計算機體系結搆	電腦架構
訊號量	號誌
討論區	論壇
訪問	訪問 存取
訪問控制表	存取控制列表
訪問量	瀏覽量
設備	裝置
設置	設定
註冊機	序號產生器
註冊表	登錄檔
註銷	登出
評測系統	解題系統
認知障礙症	失智症
語法高亮	語法突顯
語義	語意
語義網	語意網
語言包	語言套件
誤差	殘留誤差
調制	調變
調制解調器	數據機
調度	排程
調度器	排程器
調用	呼叫
調用層接口	呼叫層級介面
調色板	調色盤
調製解調器	數據機
調試	除錯
調試	除錯 偵錯
調試器	偵錯程式
請勿追蹤	停止追蹤
諾頓克隆精靈	諾頓魅影系統
證書	憑證
識別	辨識
護士	護理師
讀卡器	讀卡機
變換	轉換
變構	異位
變速圓周運動	變速率圓周運動
變量	變數
谷氨	麩胺
谷氨酰胺	麩醯胺酸
谷氨酸	麩胺酸
谷甾醇	穀固醇
谷翔信息技朮	谷翔信息技術
谷芽	穀芽
谷草轉氨酶	麩草轉胺酶
谷蛾科	蕈蛾科
豆甾醇	豆固醇
象甲科	象鼻蟲科
豪斯多夫	郝斯多夫
貝克勒爾	貝克勒
貝塔	貝他
貝塞爾曲線	貝茲曲線
貝德諾爾茨	比得諾茲
貝葉斯估計	貝氏估計
貝葉斯定理	貝氏定理
貝葉斯推斷	貝氏推論
貝葉斯概率	貝氏機率
貝葉斯法則	貝氏定理
貝葉斯理論	貝氏定理
貝葉斯統計	貝氏統計
貪心法	貪婪法
貪心算法	貪婪演算法
貴氣體	惰性氣體
費密能級	費米階
費希爾	費雪
資源管理器	檔案總管
資訊年代	資訊時代
資訊科學	資訊學
資訊總監	資訊長
賦值運算符	設定運算子
賦范	賦範
質粒	質體
質素	品質
質量	品質
質體外途徑	原生質體外路徑
質體外運輸	原生質體外運輸
賬戶	帳戶
賬號	帳號
賴氨酸	離胺酸
赤蘚糖	赤藻糖
赤蘚酮糖	赤藻酮糖
赤霉素	吉貝素
赤黴素	吉貝素
超文本標記語言	超文件標示語言
超文本置標語言	超文件標示語言
超時	逾時
超極本	超極致筆電
超編程	超程式設計
超聲心動圖	心臟超音波
超聲波	超音波
超靜定	靜不定
跖趾	蹠趾
跖骨	蹠骨
跗跖	跗蹠
跨性別激素療法	跨性別荷爾蒙治療
跳蛛科	蠅虎科
身份	身分
軌態	軌域
軌道	軌域
軍團病	退伍軍人病
軟件	軟體
軟件包	軟體套件
軟件包管理系統	軟體套件管理系統
軟件套件	軟體套件
軟件套件管理系統	軟體套件管理系統
軟件流程	軟體流程
軟件過程	軟體流程
軟件開發套件	軟體開發套件
軟件開發工具包	軟體開發套件
軟盤	軟碟
軟盤驅動器	軟碟機
軟驅	軟碟機
輕觸式熒幕	觸控式螢幕
輕觸熒幕	觸控螢幕
轉基因	基因轉移
轉氨酶	轉胺酶
轉義	跳脫
轉義字符	跳脫字元
近親三角蛛	扇網蛛
退出應用程序	結束應用程式
退出程序	結束程式
退相干	去相干
逆元	反元素
逆轉錄	反轉錄
通信	通訊
通信順序進程	交談循序程式
通用串行總線	通用序列匯流排
通訊卡	通話卡
通配符	萬用字元
連接	連線
連接器	聯結器
連續互通	接續互通
進制	進位制
進程	程序 進程
進程控制塊	過程控制段
進程組	行程群組
進程間	行程間
進程間通信	行程間通訊
遊蛇科	黃頷蛇科
運算符	運算子
運籌學	作業研究
運行	執行
過氧化物酶體	過氧化體
過程化	程序化
過程式	程序式
過程式編程	程序式程式設計
道路連通	路徑連通
遞推關系	遞迴關係
遞歸	遞迴
遞歸關係	遞迴關係
遠程	遠端
遠程桌面協議	遠端桌面協定
遠程過程調用	遠端程序呼叫
適配器	介面卡 配接器
選項卡	索引標籤
邁克耳孫	邁克生
邏輯卷管理	邏輯捲軸管理
邏輯器件	邏輯裝置
邏輯門	邏輯閘
邦費羅尼	邦佛洛尼
郭公甲	郭公蟲
郵件列表	郵寄清單
郵箱	電子信箱
鄰氯青霉素	氯噁唑西林
酉矩陣	么正矩陣
酉空間	么正空間
酉群	么正群
配合物	錯合物
配置	組態
配置文件	組態檔 設定檔
配離子	錯離子
配體	配位基
酮症酸中毒	酮酸血症
酰	醯 醯
酰胺	醯胺
醋制	醋製
醫學觀察	醫療觀察
釆樣率	取樣率
里德伯	芮得柏
重命名	重新命名
重啟	重新啟動
重定向	重新導向
重定向頁	重新導向頁面
重復組	重複群
重症監護室	加護病房
重置	重設
重裝	重新安裝 重灌
重載	多載 過載
量子比特	量子位元
量綱	因次
金屬氧化物半導體	金氧半導體
金花魚黃草	菜欒藤
金葡菌激酶	葡萄球菌激酶
金蟬蛛屬	黑條蠅虎屬
金霉素	氯四環黴素
金龜科	金龜子科
鈁	鍅 鍅
鈈	鈽 鈽
鈉鉀泵	鈉鉀幫浦
鈎子	勾點
鈎距蝦脊蘭	鉤距蝦脊蘭
鈣信號	鈣訊號
鈣通道	鈣離子通道
錄像	錄影
錄像帶	錄影帶
錇	鉳 鉳
錐栗屬	栲屬
錶面玻璃	錶玻璃
鍀	鎝 鎝
鍬甲科	鍬形蟲科
鍵盤布局	鍵盤配置
鎄	鑀 鑀
鎇	鋂 鋂
鎿	錼 錼
鏈反應	連鎖反應
鏈式反應	連鎖反應
鏈式法則	連鎖律
鏈接	連結
鏈接反向	鏈結反向
鏈接搜索	鏈結搜尋
鏈接正向	鏈結正向
鏈蚧	鏈介殼蟲
鏈表	連結串列
鏡像	映象
鏽革孔菌	刺革菌
鐘南山	鍾南山
鐦	鉲 鉲
鐳射	雷射
鐳射影碟	雷射影碟
鑥	鎦 鎦
長嫵蛛	長夜蛛
長嫵蛛屬	夜蛛屬
長腹蒙蛛	箭形蠅虎
長蟱蛛	長夜蛛
長蟱蛛屬	夜蛛屬
門戶系統	入口網站
門戶網站	入口網站
門捷列夫	門得列夫
門電路	閘電路
閃存	快閃記憶體
閃迪	新帝
閉圖像定理	閉圖定理
開放手持設備聯盟	開放手機聯盟
開放移動聯盟	開放行動聯盟
開普勒	克卜勒
開機	啟動
開機切換	啟動切換
開爾文	克耳文
間隔缺損	中隔缺損
閔可夫斯基	閔考斯基
關係數據庫	關聯式資料庫
關系數據庫	關聯式資料庫
阿伏伽德羅	亞佛加厥
阿伏伽德羅常量	亞佛加厥常數
阿佛加德羅	亞佛加厥
阿佛加德羅常數	亞佛加厥常數
阿倫尼烏斯	阿瑞尼士
阿內蛛屬	粗腳姬蛛屬
阿司匹林	阿斯匹靈
阿士匹靈	阿斯匹靈
阿爾茨海默病	阿茲海默症
阿片	鴉片
阿莫西林	安默西林
阿里云計算	阿里雲計算
阿里山鈍頭蛇	駒井氏鈍頭蛇
附加組件	附加元件
陣列服務器	陣列伺服器
陣列硬盤	陣列硬碟
除余	除餘
陳述式	語句
陶中微子	濤微中子
隆喜蟱蛛	隆背菲蛛
隆金龜科	厚角金龜科
隊列	佇列
隧穿	穿隧
隨機數	亂數
隱失波	漸逝波
隱翅甲科	隱翅蟲科
隱身模式	無痕模式
隱馬爾可夫模型	隱藏式馬可夫模型
集成	整合
集成設備電路	整合裝置電路
集成開發環境	整合式開發環境
集成電路	積體電路
集羣	叢集
集群	叢集
雙參函數	二元函數
雙名法	二名法
雙射	對射
雙氯西林	雙氯噁唑西林
雙通道	雙連結
雜化	混成
離解	解離
雲存儲	雲端儲存
雲計算	雲端計算
零假設	虛無假說
零元	零元素
雷斯勒	萊斯納
電介質強度	介電強度
電信運營商	電信業者
電偶極子	電雙級
電勢	電位
電子云	電子雲
電子偶素	正子電子偶
電子表格	電子試算表
電弱相互作用	電弱交互作用
電源保護	不斷電系統
電腦產生圖像	電腦合成影像
電訊供應商	電信業者
電訊公司	電信公司
電訊商	電信商
電訊服務	電信服務
電訊業	電信業
電訊行業	電信行業
電負性	電負度
電郵	電子郵件
電離	游離
電離能	游離能
電離輻射	游離輻射
電鰩	電鱝
靜態類型	靜態型別
非典	SARS
非參數	無母數
非甾體抗炎藥	非類固醇抗發炎藥
面向代理編程	代理人導向程式設計
面向堆棧	堆疊導向
面向對象	物件導向
面向對象編程	物件導向程式設計
面向并發	平行導向
面向文檔	文件導向
面向消息	訊息導向
面向消息的中間件	訊息導向中介層
面向語言的程序設計	語言導向程式設計
面向過程	程序導向
面向類	類別導向
面天原指樹蛙	面天樹蛙
面簿	臉書
鞘氨醇	鞘胺醇
鞘腹蛛屬	鞘腹姬蛛屬
音頻	音訊
音頻文件	音訊檔
音頻文檔	音訊檔
音頻檔	音訊檔
音頻軌	音訊軌
音頻輸入	音訊輸入
音頻輸出	音訊輸出
頁眉	頁首
頁腳	頁尾
項目	專案
項目頁	計畫頁
順序規則	序列法則
預處理器	前處理器
頭孢噻呋	畜福
頭文件	標頭檔 標頭檔案
頻分多址	分頻多重進接
頻分複用	分頻多工
頻哪醇	嚬哪醇
顆粒白血球	顆粒球
類加載器	類別載入器
類型	型別
類型檢查	型別檢查
類型系統	型別系統
類域	類體
類定義	類別定義
類實例	類別實例
類庫	類別館
類成員	類別成員
類方法	類別方法
類模板	類別模板 類别範本
類的實例	類別的實例
類的搆造函數	類別的建構函數
類的析搆函數	類別的破壞函數
類聲明	類別宣告
類變量	類別變數
顯像管	映像管 映象管
顯卡	顯示卡
顯存	視訊記憶體
顯著性水平	顯著水準
顯著水平	顯著水準
風河	溫瑞爾
風疹疫苗	德國麻疹疫苗
飛兆半導體	快捷半導體
飛虱科	稻蝨科
飛行模式	飛航模式
食欲肽	食慾素
食管	食道
首席信息官	資訊長
首席執行官	執行長
首席技朮官	技術長
首席技術官	技術長
首席運營官	營運長
首選項	偏好設定
香菇多糖	蘑菇多糖
馬氏規則	馬可尼可夫法則
馬爾可夫	馬可夫
馬爾科夫尼科夫	馬可尼可夫
馬蹄蓮	海芋
騰訊云計算	騰訊雲計算
驅動程序	驅動程式
骨痛熱症	登革熱
體外膜氧合	葉克膜
體細胞高頻突變	體細胞超突變
高保真	高傳真
高性能計算	高效能運算
高氙酸	過氙酸
高氯酸	過氯酸
高清	高畫質
高清多媒體介面	高畫質多媒體介面
高清多媒體界面	高畫質多媒體介面
高清音質	高音質
高清音頻	高音質音訊
高溴酸	過溴酸
高爾基	高基
高爾基體	高基氏體
高碘酸	過碘酸
高端	高階 進階
高級	進階
高級	高階 進階 高級
高級編程語言	高階程式語言
高級語言	高階語言
高速緩存	快取記憶體
高速緩沖存儲器	高速緩衝記憶體
高錳酸	過錳酸
高錸酸	過錸酸
高鍀酸	過鎝酸
高鐵酸	鐵酸
鮑爾默	巴爾默
鰓蛤莫蛛	鰓蛤蟆蛛
鴨子類型	鴨子型別
鸞鳳玉	多蕊仙人球
鹵代炔	鹵炔
鹵代炔烴	鹵炔
鹵代烯	鹵烯
鹵代烯烴	鹵烯
鹵代烷	鹵烷
鹵代烷烴	鹵烷
麒麟葉	拎樹藤
麒麟葉屬	拎樹藤屬
麗木虱	麗木蝨
麗蛛屬	金姬蛛屬
麥克斯韋	馬克士威
麥芽酚	麥芽醇
麥賽爾森	梅瑟生
麻哈魚屬	鉤吻鮭屬
麻腮	麻疹腮腺炎
麻腮風	麻疹腮腺炎德國麻疹
麻腮風三聯	麻疹腮腺炎德國麻疹混合
麻風疫苗	麻疹德國麻疹疫苗
黃蛋白反應	薑黃反應
黑客	駭客
黑屏	黑畫面
黑盒測試	黑箱測試
黑貓跳蛛	橙黃蠅虎
默認	預設
默認值	預設值
點對點	對等
點擊	點選
鼠標	滑鼠
龍虱	龍蝨
鿔	鎶
鿭	鉨
