Billboard二百強專輯榜	告示牌二百大專輯榜
Billboard百強單曲榜	告示牌百大單曲榜
Eminem	阿姆
Gaon數字榜	Gaon單曲榜
Muse	謬思合唱團
Nike	耐吉
Nirvana	超脫樂團
Parkour	跑酷
SHARP	夏普
Yamaha	山葉
七人欖球	七人制橄欖球
七國集團	七大工業國組織
三角鋼琴	平台鋼琴
三項鐵人	鐵人三項
不列顛哥倫比亞大學	英屬哥倫比亞大學
世界反興奮劑機搆	世界反運動禁藥機構
世界大學生運動會	世界大學運動會
世界盃乒乓球賽	世界盃桌球賽
世界盃欖球賽	世界盃橄欖球賽
中樂團	國樂團
主音歌手	主唱
互聯網檔案館	網際網路檔案館
亞東魚	鮪魚
亞殘會	亞帕運
亞殘運會	亞帕運
亞洲殘疾人運動會	亞洲帕拉運動會
亞細安	東協
亞細安組織	東南亞國家協會
亨德爾	韓德爾
伊米爾	尤彌爾
伯克利	柏克萊
低保真	低傳真
低音結他	貝斯
低音電結他	電貝斯
佛蘭德	法蘭德斯
佩劍	軍刀
信息主管	資訊總監
俯臥撐	伏地挺身
借記卡	簽帳金融卡
健力士世界紀錄	金氏世界紀錄
傻朋克	傻瓜龐克
儀樂隊	樂儀隊
元音	母音
光盤	光碟
光輝道路	光明之路
克柔術	克拉術
克羅地亞	克羅埃西亞
克魯釆	克羅釆
內政和國土部	內政和家園部
八分之一決賽	16強賽
八國集團	八大工業國組織
八強賽	半準決賽
公告牌	告示牌
公告牌二百強專輯榜	告示牌二百大專輯榜
公告牌百強單曲榜	告示牌百大單曲榜
六國集團	六大工業國組織
共和聯邦	大英國協
冰棍	冰棒
凱林賽	競輪賽
凱爾特女人	天使女伶
出租車	計程車
切利比達克	傑利畢達克
刻律涅	克列尼亞
刻耳	克爾
前地	廣場
劍擊	擊劍
加州大學伯克利分校	加州大學柏克萊分校
加里和領跑者組合	蓋瑞與前導者合唱團
勃拉姆斯	布拉姆斯
勛伯格	荀白克
勞工和社會保障部	勞動及社會事務部
包豪斯	包浩斯
北歐兩項	北歐混合式滑雪
十六分之一決賽	32強賽
十強串流	十大串流
十強單曲	十大單曲
十強專輯	十大專輯
十強數字	十大數位
十強數碼	十大數位
十強歌曲	十大歌曲
十強流媒體	十大串流
十強電台	十大電台
升特	陞特
半決賽	準決賽
南方小雞	狄克西女子合唱團
博弈管理	賭場管理
博諾	波諾
卡伊達組織	蓋達組織
卡內基梅隆大學	卡內基美隆大學
卡尼基美隆大學	卡內基美隆大學
卡巴列夫斯基	卡巴賴夫斯基
卡爾海因茨	卡爾海因茲
卡特彼勒	開拓重工
卡特比勒	開拓重工
即食麪	速食麵
厄客德娜	艾奇德娜
古拉什	克拉術
台球	桌球
史丹福	史丹佛
史丹福大學	史丹佛大學
史加爾亞賓	史克里亞賓
史密夫飛船	史密斯飛船
吉尼斯世界紀錄	金氏世界紀錄
吞拿魚	鮪魚
和聲	和聲歌手
和音	和聲歌手
咖喱	咖哩
哈帝斯	黑帝斯
哈恰圖良	哈察都量
哈爾斯坦	霍爾斯坦
哈耳庇厄	哈比
哈迪斯	黑帝斯
哥德堡	哥特堡
哥特	哥德
唐納德	唐納
喀戎	凱隆
單車	自由車
四分之一決賽	半準決賽
國際乒聯世界杯	世界盃桌球賽
國際排總女子排球世界盃	世界盃女子排球賽
國際排總排球世界盃	世界盃排球賽
國際排總男子排球世界盃	世界盃男子排球賽
國際排聯女子排球世界杯	世界盃女子排球賽
國際排聯排球世界杯	世界盃排球賽
國際排聯男子排球世界杯	世界盃男子排球賽
國際籃總籃球世界盃	世界盃籃球賽
國際籃聯籃球世界杯	世界盃籃球賽
國際貿易朮語	國際商業用語
國際貿易朮語解釋通則	國貿條規
團結工會	團結工聯
在彩虹中	彩虹裡
埃爾加	艾爾加
埃爾斯蒂克	歐伊斯特拉赫
埃米納姆	阿姆
基地組織	蓋達組織
基辛	紀新
塑料	塑膠
塞格斯坦	賽格斯坦
士碌架	司諾克
夏威夷小結他	烏克麗麗
夏布里埃	夏布里耶
大先生樂隊	大人物合唱團
大號	低音號
大運會	世大運
奇倫	凱隆
奔馳	賓士
奧伊斯特拉赫	歐伊斯特拉赫
奶酪	乳酪
好時年	固特異
威瑞森	威訊
威風堂堂	威風凜凜
孟德爾遜	孟德爾頌
安德瓦里	安德瓦利
安格爾博達	安格爾波達
室樂	室內樂
容克	榮克
富特文格勒	福特萬格勒
寶潔	寶鹼
小紅莓樂隊	小紅莓合唱團
尤克里里	烏克麗麗
尼特立哥	涅翠柯
峇釐	峇里
巴倫博伊姆	巴倫波因
巴倫邦	巴倫波因
巴托	巴爾托克
巴托克	巴爾托克
巴赫	巴哈
巴釐	峇里
市場總監	行銷長
布列玆	布萊茲
布烈頓	布瑞頓
布里頓	布瑞頓
希爾貝克	歇爾貝克
希路斯	海利歐斯
帕赫貝爾	帕海貝爾
幼兒園	幼稚園
康奈爾	康乃爾
康奈爾大學	康乃爾大學
弗勞恩霍夫協會	夫朗和斐協會
弗拉門戈	佛朗明哥
弗朗茨	法蘭茲
弗洛倫斯與機器	芙蘿倫絲機進份子
強生	嬌生
彈床	彈翻床
彪羅	畢羅
德伏扎克	德弗札克
德士	計程車
德彪西	德布西
德沃夏克	德弗札克
快意	飛雅特
快速面	速食麵
戈塞克	哥塞克
戰前女神	懷舊女郎
戴流士	大流士
戴留斯	大流士
披頭士	披頭四
拉冬	拉頓
拉特	盧特
拉赫瑪尼諾夫	拉赫曼尼諾夫
拜羅伊特音樂節	拜律特音樂節
持旗手	掌旗官
捷米爾卡諾夫	泰密卡諾夫
掌上壓	伏地挺身
揚松斯	楊頌斯
摔角	角力
摔跤	角力
數字下載	數位下載
數字化和交通部	數位及交通部
數字單曲	數位單曲
數字專輯	數位專輯
數字廳	數位廳
數字榜	數位榜
數字歌曲	數位歌曲
數字版	數位版
數字發行	數位發行
數字音樂	數位音樂
數字音樂下載	數位音樂下載
數碼下載	數位下載
數碼及交通部	數位及交通部
數碼單曲	數位單曲
數碼專輯	數位專輯
數碼廳	數位廳
數碼榜	數位榜
數碼歌曲	數位歌曲
數碼版	數位版
數碼發行	數位發行
數碼音樂	數位音樂
數碼音樂下載	數位音樂下載
斯克里亞賓	史克里亞賓
斯卡拉蒂	史卡拉第
斯坦福	史丹佛
斯坦福大學	史丹佛大學
斯特拉文斯基	史特拉汶斯基
斯美塔那	史麥塔納
斯諾克	司諾克
方便面	速食麵
方便麪	泡麵 速食麵
施尼特凱	舒尼特克
施托克豪森	史托克豪森
施樂	全錄
施特勞斯	史特勞斯
施瓦茨科普夫	舒娃茲柯芙
施蓮娜	塞勒涅
旗手	掌旗官
昂山素姬	翁山蘇姬
昂山素季	翁山蘇姬
普列特涅夫	普雷特涅夫
普度大學	普渡大學
普羅科菲耶夫	普羅高菲夫
朋克	龐克
朝鮮戰爭	韓戰
李彥宏	李彥宏
杜達梅爾	杜達美
東南亞國家聯盟	東南亞國家協會
東盟	東協
林肯公園	聯合公園
柏遼玆	白遼士
查爾達什	查爾達斯
柯達伊	高大宜
格什溫	蓋希文
格林卡	葛令卡
格林美	葛萊美
格芯	格羅方德
格萊美	葛萊美
格蘭傑	葛人傑
格蘭杰	葛人傑
格里格	葛利格
梅西安	梅湘
橄欖球世界杯賽	世界盃橄欖球賽
欖球	橄欖球
欣德米特	亨德密特
歌舒詠	蓋希文
歐洲及外交事務部	歐洲暨外交事務部
歐洲委員會	歐洲理事會
歐洲理事會	歐盟高峰會
歐洲空間局	歐洲太空總署
歐洲聯盟委員會	歐洲執行委員會歐盟執行委員會
歐洲與外交事務部	歐洲暨外交事務部
歐洲足協	歐洲足總
歐洲足聯	歐洲足總
歐盟委員會	歐盟執委會
歐足協	歐足總
歐足聯	歐足總
正大集團	卜蜂集團
殘奧	帕運
殘委會	帕委會
殘疾人奧林匹克	帕拉林匹克
殘疾人奧林匹克運動會	帕拉林匹克運動會
殘疾人運動會	帕拉運動會
比利亞松	費亞松
比約克	碧玉
民樂團	國樂團
沃爾特	華特
沙斯卡寸旺大學	薩克其萬大學
治療樂隊	怪人合唱團
法蘭明歌	佛朗明哥
波塞冬	波賽頓
泰勒曼	泰雷曼
泰米爾	坦米爾
流媒體	串流媒體
浦羅哥菲夫	普羅高菲夫
浦賽爾	普賽爾
海內存知己	海內存知己
海廷克	海汀克
海柏利昂	許珀里翁
海格力斯	海克力斯
海菲茨	海飛茲
海費茲	海飛茲
涅槃樂隊	超脫樂團
涅特列布科	涅翠柯
涼菜	冷盤
淡米爾	坦米爾
清唱劇	神劇
清唱套曲	清唱劇
滑翔傘	飛行傘
滾軸溜冰	滑輪溜冰
澳新銀行	澳盛銀行
火車樂隊	追隨者合唱團
牟利	營利
特里斯坦與伊索爾德	崔斯坦與伊索德
獨木舟	輕艇
獨立國家聯合體	獨立國家國協
獨聯體	獨立國協
珀塞爾	普賽爾
琴鍵	鍵盤
瓦格納	華格納
甜園樂隊	甜園合唱團
當奴	唐納
百強串流	百大串流
百強單曲	百大單曲
百強專輯	百大專輯
百強數字	百大數位
百強數碼	百大數位
百強歌曲	百大歌曲
百強流媒體	百大串流
百強電台	百大電台
的士	計程車
的士高	迪斯可
皇后樂隊	皇后合唱團
皮划艇	輕艇
皮同	培冬
知識產權	智慧財產權
短節目	短曲
短道速滑	短道競速滑冰
硬核	硬蕊
社會事務與衛生部	社會事務及衛生部
福布斯	富比士
福雷	佛瑞
科普蘭	柯普蘭
程序不正義	程序不正義
程序正義	程序正義
積體電路制造公司	積體電路製造公司
空中鐵匠	史密斯飛船
空氣淨化器	空氣清淨機
笨豬跳	高空彈跳
策姆林斯基	哲林斯基
節奏布魯斯	節奏藍調
約爾蒙干德	耶夢加得
約通海姆	約頓海姆
納斯達克	那斯達克
索尼影業	索尼影視娛樂
索爾蒂	蕭提
細碟	迷你專輯
結他	吉他
綁緊跳	高空彈跳
經濟合作與發展部	經濟合作及發展部
經濟和氣候保護部	經濟事務和氣候行動部
維尼亞夫斯基	維尼奧夫斯基
維拉臣	費亞松
維斯特里	威斯特里
維珍	維京
維瓦爾第	韋瓦第
繆斯樂隊	謬思合唱團
羅斯卓波維契	羅斯卓波維奇
羅斯特羅波維奇	羅斯卓波維奇
美國國家航空航天局	美國國家航空暨太空總署
美國在線	美國線上
美國太空總署	美國國家航空暨太空總署
羽毛球	羽球
翁山淑枝	翁山蘇姬
老佛爺百貨公司	拉法葉百貨公司
耐克	耐吉
聲樂套曲	聯篇歌曲
肖斯塔科維奇	蕭士塔高維奇
肖邦	蕭邦
背泳	仰泳
腳車	自由車
自由泳	捷泳
自由滑	長曲
自行車	腳踏車 自由車
舒尼格	舒尼特克
舒瓦茲柯芙	舒娃茲柯芙
色士號	薩氏號
色士風	薩氏管
艾夫斯	艾伍士
艾維士	艾伍士
花劍	鈍劍
花式溜冰	花式滑冰
花樣游泳	藝術游泳
花樣滑冰	花式滑冰
英偉達	輝達
英聯邦	大英國協
荀伯克	荀白克
莫什科夫斯基	莫茲可夫斯基
莫扎特	莫札特
華樂團	國樂團
華隆	瓦隆
菲亞特	飛雅特
萊比錫布業大廳管弦樂團	萊比錫布商大廈管弦樂團
萊特	盧特
萊茵河航運中央委員會	萊茵河航運中央執委會
蕭斯達高維契	蕭士塔高維奇
薩克斯管	薩氏管
薩克斯號	薩氏號
薩拉薩蒂	薩拉沙泰
薩斯喀徹溫大學	薩克其萬大學
薩格士譚	賽格斯坦
薩蒂	薩提
藝朮體操	韻律體操
藝術體操	韻律體操
蘇薩	蘇沙
蘇薩號	蘇沙號
蜆殼	殼牌
行政總裁	執行長
西諾波利	辛諾波里
西貝柳斯	西貝流士
西部數據	威騰電子
角斗士	角鬥士
許德拉	海卓拉
許茨	舒茲
詞組	片語
說唱	饒舌
諾爾德里	諾德里
財富	財星
賀路域玆	霍羅威茨
資本家雜志	富比士
賓夕凡尼亞大學	賓州大學
賓夕法尼亞大學	賓州大學
賽艇	划船
贊臣士	楊頌斯
赫利俄斯	海利歐斯
赫拉	希拉
赫拉克勒斯	海克力斯
赫爾茨	海爾次
蹦床	彈翻床
蹦極	高空彈跳
蹦極跳	高空彈跳
車爾尼	徹爾尼
輔音	子音
輪滑	滑輪溜冰
辣妹組合	辣妹合唱團
返始	反始
迪斯科	迪斯可
迪斯科癟三	迪斯可癟三
通過	透過 通過
速度滑冰	競速滑冰
運動場	體育場
達律斯	大流士
釆樣	取樣
重劍	銳劍
金槍魚	鮪魚
鈎球	曲棍球
鋼架雪車	空架雪車
門德爾松	孟德爾頌
閉幕禮	閉幕式
開幕及閉幕禮	開閉幕式
開幕禮	開幕式
阿什肯納齊	阿胥肯納吉
阿佛洛狄忒	阿芙蘿黛蒂
阿斯特賴俄斯	亞斯特拉歐斯
阿格里奇	阿格麗希
阿殊堅納西	阿胥肯納吉
阿比路錄音室	艾比路錄音室
阿爾維斯	亞爾維斯
阿爾蓋達組織	蓋達組織
阿緹蜜絲	阿提米絲
阿耳忒彌斯	阿提米絲
阿耳戈斯	阿古士
阿芙蘿迪蒂	阿芙蘿黛蒂
阿賓朗尼	阿爾比諾尼
阿革諾耳	阿格諾
阿馬德烏斯	阿瑪迪斯
隱私	私密
雅納切克	楊納傑克
雅羅	耶羅
雅馬哈	山葉
雇佣	僱用
霍士	福斯
霍尼韋爾	漢威聯合
霍洛維茨	霍羅威茨
非牟利機構	非營利組織
韋伯恩	魏本
韋華第	韋瓦第
音樂視頻	音樂錄影帶
音樂錄像	音樂錄影帶
韻律操	韻律體操
韻律泳	藝術游泳
項目	專案
飛兆半導體	快捷半導體
飛霞	飛雅特
食品和農業部	食品及農業部
首席品牌官	品牌長
首席執行官	執行長
首席財務官	財務長
首席運營官	首席營運長
馬斯特里赫特	馬斯垂克
馬斯特里赫特條約	馬斯垂克條約
骨痛熱症	登革熱
體育興奮劑	運動禁藥
高保真	高傳真
鮑海貝爾	帕海貝爾
鮑羅丁	鮑羅定
麒麟賽	競輪賽
麥卡特尼	麥卡尼
麥吉爾大學	麥基爾大學
黃宏	黃宏
齊默爾曼	齊瑪曼
