乾	乾 干
剋	克 剋	表示訓斥、打人時，不簡化作「克」
吒	咤 吒	用於姓氏人名時不規範作「咤」
噁	恶 𫫇	「𫫇」爲化學名詞用字，如「二𫫇英」。	可恶 恶心 二𫫇英
徵	徵 征	解作五音之一的徵音時不簡化作「征」
於	于 於
昇	升 昇	用於姓氏人名時不簡化作「升」
椏	丫 椏	用於姓氏人名、地名、科技術語時類推簡化作「桠」，不簡化作「丫」
氾	泛 氾	用於姓氏人名時不規範作「泛」
沈	沈 沉
甦	苏 甦	用於姓氏人名時不簡化作「苏」
甯	宁 甯	用於姓氏人名時不簡化作「宁」
畫	画 划
瞭	瞭 了
祕	秘 祕	用於姓氏人名時不規範作「秘」
絜	絜 洁	用於姓氏人名時不簡化作「洁」
脩	修 脩	解作乾肉時不規範作「修」
著	着 著
蒐	搜 蒐	解作草名或春獵時不規範作「搜」
藉	藉 借
蘋	苹 𬞟	「𬞟」爲一種蕨類植物，生於淺水，四片小葉似「田」字，亦稱「田字草」，音pin2，粵音pan4。蘋果之「苹」音ping2，粵音ping4。
衹	衹 只	解作地神時不規範作「只」
袷	夹 袷	用於「袷袢」時不規範作「夹」
覆	覆 复
逕	径 迳	用於姓氏人名、地名時類推簡化作「迳」，不規範作「径」
釐	厘 釐	通「禧」時不簡化作「厘」
鉅	巨 钜	用於姓氏人名是類推簡化作「钜」，不規範作「巨」
鍊	炼 链
陞	升 陞	用於姓氏人名時不簡化作「升」
颺	扬 颺	用於姓氏人名時類推簡化作「飏」，不規範作「扬」