㨗	捷
讐	仇 讎
閤	閤 闔 閣
櫥	橱
櫕	攢
猙	狰
冣	最
襃	褒
栢	柏
厛	廳
舖	鋪
蜖	蛔
㡌	帽
淩	凌
儌	僥
邨	村 邨
劄	札 劄
醆	盞
𣙜	榷
欱	喝
嫰	嫩
躕	蹰
塲	場
蜋	螂
荘	莊
飤	飼
㥦	愜
嘅	慨
畊	耕
粧	妝
颷	飆
斍	覺
菉	緑 菉
銲	焊
穽	阱
賉	恤
煖	暖
擣	搗
璢	琉
愬	訴
亙	亘
䴸	麩
艸	草
勌	倦
鉤	鈎
沍	冱
𡨘	冤
㠯	以
潃	滫
䟎	趲
鞌	鞍
𤱈	畝
註	注
埰	采
皐	皋
檁	檩
堦	階
讃	贊
盃	杯
羋	芈
慽	戚
為	爲
鍼	針
䘏	恤
吚	咿
𩎢	弢
椏	丫 椏
滛	淫
踁	脛
吒	吒 咤
眥	眦
肻	肯
𩳁	䰡
蘯	蕩
痐	蛔
湊	凑
惪	德
刦	劫
囘	回
椶	棕
錄	録
甦	蘇 甦
厰	廠
璿	璇 瓊
誌	志
矦	侯
筞	策
猨	猿
㘭	坳
歛	斂
鬉	鬃
騐	驗
濬	浚
箠	棰
瞇	眯
塚	冢
灩	灧
㤙	恩
熅	煴
蔥	葱
棃	梨
𡨥	寇
昬	昏
醻	酬
庽	寓
禩	祀
夠	够
拕	拖
鬦	鬥
旂	旗
耡	鋤
𣯶	毿
裌	夾
餵	喂
鮌	鯀
曏	嚮
蹔	暫
蔆	菱
槕	桌
迺	乃 迺
笻	筇
譲	讓
䝔	獾
驩	歡
鵰	雕
痳	淋
鏽	銹
柟	楠
縚	縧
燐	磷
佇	伫
茲	兹
鎲	钂
碕	埼
絜	潔 絜
兔	兔
斲	斫
慇	殷
涼	凉
畒	畝
偹	備
掽	碰
殽	淆 殽
煑	煮
慙	慚
賔	賓
餹	糖
蚘	蛔
豎	竪
餁	飪
閧	哄
勑	敕 勑
証	證
僱	雇
糉	粽
孼	孽
䕃	蔭
櫈	凳
樐	櫓
飇	飆
綠	緑
麪	麵
溈	潙
汎	泛
鯗	鮝
襢	袒
窰	窑
拏	拿
銭	錢
絏	紲
㳄	涎
椉	乘
訢	欣 訢
搾	榨
槓	杠
蹤	踪
盌	碗
豓	艷
瑤	瑶
𠴰	咱
旣	既
麴	麯 麴
粬	麯
彿	佛
睜	睁
翺	翱
鱷	鰐
飱	飧
闘	鬥
牴	抵
𭁵	寇
湧	涌
獧	狷
跥	跺
綘	縫
遙	遥
厪	廑
亁	乾
靦	腼 靦
榲	榅
幮	㡡
蛕	蛔
䰟	魂
崐	昆
稟	禀
麼	麽
𩓐	脖
頼	賴
攟	捃
昚	慎
寛	寬
鰮	鰛
虵	蛇
慂	恿
奔	奔
廄	厩
鬪	鬥
悞	誤
懍	懔
蹠	跖
𠕂	再
蹵	蹴
戩	戬
換	换
旹	時
廻	迴
㬪	叠
顦	憔
啎	忤
卽	即
瀦	潴
栁	柳
菓	果
粺	稗
軆	體
㕁	却
櫂	棹
氳	氲
釬	焊
壎	塤
岅	坂
㳒	法
鑵	罐
皷	鼓
菴	庵
佔	占
茘	荔
睒	䀹
諐	愆
鼃	蛙
癒	愈
朮	术 秫
滙	匯
鞝	緔
敂	叩
穨	頽
垜	垛
挩	捝
驘	騾
缷	卸
槼	規
擕	携
寀	采
妬	妒
帀	匝
兾	冀
淼	渺 淼
檝	楫
欍	柩
堿	碱
𨶏	闕
韈	襪
瘖	喑
搥	捶
褭	裊
幑	徽
蘃	蕊
峝	峒
攜	携
騘	驄
𦍑	羌
隠	隱
倖	幸
嚐	嘗
蘊	藴
釐	厘 釐 禧
絕	絶
禿	秃
罵	駡
艪	櫓
秊	年
匄	丐
𤰜	畝
儗	擬
羇	羈
譌	訛
礟	炮
蒭	芻
剉	銼
鬭	鬥
譟	噪
躭	耽
勲	勛
筯	箸
啑	喋
裵	裴
鍅	鈁
椗	碇
晻	暗
㩀	據
塜	冢
蝡	蠕
凢	凡
槨	椁
枩	松
埳	坎
搆	構
嵳	嵯
従	從
樑	梁
踰	逾
儵	倏
雰	氛
佀	似
乕	虎
嫋	裊
㠶	帆
奧	奥
隉	陧
秌	秋
歿	殁
㨪	晃
㿜	癟
淥	渌
歴	歷
冄	冉
採	采
尠	鮮
懽	歡
憇	憩
愨	慤
箇	個
屭	屓
姙	妊
揫	揪
牠	它
㧱	拿
鉅	巨 鉅
譛	譖
峯	峰
餧	喂
旾	春
䘚	卒
冺	泯
艣	櫓
𫇛	櫓
葢	蓋
剳	札
眞	真
諡	謚
襍	雜
頹	頽
灋	法
冐	冒
繖	傘
拠	據
鷴	鷳
鞾	靴
𠕅	再
栰	筏
畞	畝
崑	昆
繙	翻
搉	榷
覔	覓
㨿	據
膓	腸
囓	嚙
櫺	欞
蠭	蜂
蹏	蹄
爗	燁
逓	遞
侶	侣
酧	酬
礮	炮
晳	晰
鞵	鞋
巗	岩
餻	糕
衂	衄
𡚁	弊
𠖇	冥
働	動
戯	戲
潛	潜
捜	搜
堖	垴
託	托
𡻕	歲
枏	楠
搤	扼
搖	摇
竝	并
說	説
隖	塢
鼇	鰲
翫	玩
鑛	礦
敘	叙
䠶	射
靜	静
陗	峭
猂	悍
唕	唣
槹	槔
珎	珍
眡	視
悽	凄
譾	謭
脩	修 脩
彂	發
臯	皋
捄	救
輙	輒
莾	莽
砦	寨
敭	揚
烱	炯
陞	升 陞
譭	毁
氾	泛 氾
搵	揾
磟	碌
嗁	啼
蠒	繭
袟	帙
𡽪	徽
躶	裸
穏	穩
剎	刹
𦾟	𦶻
厤	曆
疘	肛
嶃	嶄
鬨	哄
灨	贛
晉	晋
廰	廳
颺	揚 颺
飊	飆
痠	酸
澂	澄 澂
刧	劫
灎	灧
淚	泪
屜	屉
牓	榜
疊	叠
遉	偵
鱻	鮮
熈	熙
贓	贜
昰	是
盜	盗
啟	啓
𡬶	尋
龎	龐
懃	勤
洶	汹
稭	秸
皰	疱
歘	欻
戶	户
単	單
犇	奔 犇
壊	壞
揑	捏
勣	績 勣
氂	牦
暱	昵
崢	峥
蒍	蔿
䳘	鵝
烖	灾
飃	飄
煥	焕
甕	瓮
跼	局
蝱	虻
朞	期
膃	腽
慼	戚
覇	霸
藷	薯
埜	野
囙	因
墖	塔
嵗	歲
俛	俯 俛
痾	疴
丟	丢
㕥	以
唫	吟
諮	咨 諮
躳	躬
爕	燮
嬤	嬷
姉	姊
蘤	花
剙	創
謠	謡
薙	剃
鍫	鍬
佈	布
謩	謨
荍	蕎
屆	届
貲	資 貲
駮	駁
䖏	處
偪	逼
谿	溪 谿
㢘	廉
艥	楫
関	關
疉	叠
顏	顔
虆	蔂
毬	球
鎗	槍
鈡	鐘
吳	吴
廕	蔭
獘	斃
䠀	蹚
闚	窺
呂	吕
臙	胭
瘓	痪
橅	模
襉	襇
齧	嚙
峩	峨
斚	斝
沒	没
韻	韵
盫	盦
韁	繮
嬝	裊
飜	翻
聼	聽
辤	辭
謼	呼
胷	胸
溼	濕
噓	嘘
縕	緼
帬	裙
暠	皓
卻	却
蕿	萱
挵	弄
紮	扎
碁	棋
牕	窗
諠	喧
髣	仿
㕘	參
㝠	冥
噉	啖
袴	褲
喫	吃
窻	窗
鹼	碱
椾	箋
剏	創
矙	瞰
舩	船
獎	奬
牆	墻
嶽	岳
𤱊	留
勅	敕
剝	剥
塩	鹽
尟	鮮
痺	痹
𢮥	操
廐	厩
妷	侄
惥	恿
煙	烟
奐	奂
娛	娱
鏁	鎖
軽	輕
賷	賫
𠫹	單
罋	瓮
𣈶	暅
幙	幕
奼	姹
汚	污
囪	囱
茍	苟
攅	攢
鈅	鑰
偺	咱
刪	删
儁	俊
犛	牦
獋	嗥
謟	諂
鉏	鋤
蓆	席
觕	粗
齩	咬
摃	扛
汙	污
畄	留
悅	悦
彛	彝
辳	農
蓴	蒓
湼	涅
籨	奩
䛡	話
陿	狹
紥	扎
閗	鬥
𡐨	野
嘑	呼
欝	鬱
祕	秘 祕
螎	融
劵	券
僊	仙
涗	涚
詶	酬
侷	局
瓉	瓚
咲	笑
匲	奩
迻	移
緐	繁
榘	矩
雝	雍
鑪	爐 鑪
尅	剋
弔	吊
粦	磷
㟁	岸
橜	橛
裠	裙
蟁	蚊
菑	灾
䗬	蜂
巖	岩
牎	窗
羴	膻
兌	兑
餚	肴
髈	膀
琖	盞
搇	撳
撦	扯
兠	兜
宻	密
麤	粗
婬	淫
纉	纘
閱	閲
減	减
蕋	蕊
揹	背
傚	效
蜨	蝶
𡞵	㛟
傑	杰
翄	翅
効	效
欅	櫸
宂	冗
唘	啓
篠	筱
濇	澀
枒	丫
肐	胳
窯	窑
寃	冤
掛	挂
槑	梅
渙	涣
廸	迪
廼	乃
衚	胡
隷	隸
捱	挨
𦃂	緊
桺	柳
𥤚	秋
袞	衮
讚	贊
牀	床
㩗	携
凴	憑
荊	荆
餽	饋
斵	斫
勳	勛
観	觀
蔕	蒂
亾	亡
壜	罎
蔴	麻
羗	羌
躰	體
譁	嘩
筩	筒
瘺	瘻
俬	私
騣	鬃
咊	和
慄	栗
殀	夭
斉	齊
旤	禍
菸	烟
兎	兔
喚	唤
覜	眺
袠	帙
蟇	蟆
泝	溯
㮣	概
骵	體
処	處
蝟	猬
跴	踩
嘷	嗥
蔘	參
䥥	鐮
稈	秆
廵	巡
蒐	搜 蒐
顇	悴
蝨	虱
箏	筝
線	綫 線
澁	澀
暎	映
偘	侃
㴱	深
邉	邊
櫫	橥
壠	壟
済	濟
烕	滅
餈	糍
稜	棱
囬	回
緜	綿
隄	堤
矴	碇
荳	豆
撐	撑
簷	檐
譆	嘻
贑	贛
趂	趁
湻	淳
誖	悖
蝯	猿
眾	衆
盪	蕩
蜺	霓
顋	腮
龢	和 龢
樷	叢
勻	匀
燻	熏
鴈	雁
㝛	宿
𦂳	緊
逕	徑 逕
椀	碗 椀
凟	瀆
辠	罪
艶	艷
倸	睬
毘	毗
箒	帚
觝	抵
塟	葬
叚	假 叚
𦵏	葬
侫	佞
蓭	庵
吶	呐
畧	略
溫	温
𦕈	眇
㬉	暖
醕	醇
鼈	鱉
蠍	蝎
痌	恫
冑	胄
粇	糠
罇	樽
姦	奸
謌	歌
嘠	嘎
竢	俟
尩	尪
殭	僵
蘐	萱
寳	寶
経	經
兗	兖
韮	韭
恆	恒
燄	焰
刱	創
週	周
燬	毁
䈰	筲
懐	懷
桮	杯
卹	恤
抝	拗
簒	篡
覊	羈
潄	漱
嬾	懶
齶	腭
缽	鉢
彊	强 疆 僵 彊
慾	欲
緾	纏
挱	挲
嚥	咽
仝	同 仝
冩	寫
𩗗	颶
窓	窗
橤	蕊 橤
癡	痴
彫	雕 凋
劎	劍
脗	吻
衇	脉
繦	襁
匵	櫝
叡	睿
漵	溆
钁	鐝 钁
喒	咱
覌	觀
査	查
袵	衽
強	强
霑	沾
畂	畝
煗	暖
栞	刊
罈	罎
媯	嬀
鉋	刨
甯	寧 甯
踫	碰
呪	咒
宐	宜
勗	勖
寕	寧
燉	炖
㩦	携
餱	糇
簮	簪
罸	罰
啣	銜
𠇮	命
𤺥	瘩
緥	褓
㝡	最
櫱	蘖
癄	憔
児	兒
醼	宴
姪	侄
亱	夜
㕑	厨
繐	穗
隂	陰
別	别
剷	鏟
畵	畫
災	灾
詠	咏
臝	裸
悤	匆
繃	綳
蠎	蟒
橫	横
麏	麇
覩	睹
脇	脅
芲	花
彥	彦
蚉	蚊
牋	箋
衘	銜
霤	溜
賸	剩
饍	膳
缾	瓶
脣	唇
餬	糊
崕	崖
砲	炮
諙	話
鎭	鎮
薀	蕰
甞	嘗
棄	弃
㠀	島
遶	繞
粰	麩
柺	拐
剱	劍
桿	杆
袷	夾 袷
帋	紙
髥	髯
揯	搄
鸎	鶯
覈	核
搨	拓
瑯	琅
蛻	蜕
覧	覽
穤	糯
讙	歡
㽞	留
㠝	巑
寔	實
詧	察
銳	鋭
皁	皂
沖	衝 冲
腳	脚
𢬸	括
麕	麇
鑤	刨
稉	粳
醞	醖
譔	撰
𦉆	碴
駈	驅
桒	桑
夣	夢
筦	管 筦
稅	税
葠	參
倣	仿
廚	厨
矁	瞅
𦊱	挂
賛	贊
內	内
厳	嚴
挐	拿
簑	蓑
㱕	歸
闇	暗
榦	幹
𤋮	熙
籑	饌
骽	腿
竚	伫
歳	歲
𧥢	誇
𦪙	䑽
豬	猪
屍	尸
陻	堙
綑	捆
琍	璃
艢	檣
蔾	藜
黙	默
狥	徇
鉆	鑽
傯	偬
慍	愠
㕠	雙
㼝	碗
恡	吝
軰	輩
堃	坤 堃
𥲻	纂
甖	罌
鶿	鷀
鉄	鐵
馿	驢
遊	游
巵	卮
琹	琴
𠞰	剿
懴	懺
冪	幂
籐	藤
斈	學
槖	橐
戹	厄
螡	蚊
孃	娘
䭾	馱
壈	𡒄
凈	净
圅	函
脃	脆
𠴟	咩
滾	滚
巹	卺
絃	弦
簙	博
玅	妙
唸	念
觔	斤
緪	縆
鄼	酇
衕	同
軃	嚲
骾	鯁
穉	稚
癈	廢
𩭪	䘿
贗	贋
遯	遁
酖	鴆
嵒	岩
崙	侖
絛	縧
篛	箬
冊	册
斸	劚
怳	恍
崘	侖
釦	扣
姍	姗
貛	獾
尫	尪
蓡	參
㥫	惇
臋	臀
嬭	奶
瘉	愈
產	産
㑺	俊
稬	糯
臈	臘
棊	棋
衖	弄
辢	辣
拋	抛
㒺	罔
徃	往
麐	麟
畱	留
跡	迹
㪟	敦
頫	俯 頫
墰	罎
鱓	鱔
燿	耀
慴	懾
爭	争
擧	舉
𠌂	傘
漥	窪
廂	厢
蕚	萼
盇	盍
堓	岸
匃	丐
齎	賫
䢜	歸
柵	栅
脈	脉
衞	衛
讎	仇 讎
轀	輼
綵	彩
僲	仙
廩	廪
隣	鄰
剹	戮
異	异
亝	齋
乗	乘
幚	幫
羶	膻
甎	磚
枴	拐
虗	虚
楳	梅
惏	婪
鎚	錘
𥄨	瞅
淛	浙
鼔	鼓
畆	畝
戞	戛
朂	勖
秈	籼
鵞	鵝
廝	厮
㯭	櫓
婣	姻
媮	偷
脫	脱
㱃	飲
亷	廉
𢷬	搗
靣	面
縂	總
愽	博
逩	奔
稾	稿
厀	膝
聀	職
攩	擋
蒕	蒀
敎	教
洩	泄
壻	婿
毧	絨
秔	粳
鉳	錇
眎	視
敺	驅
寜	寧
梔	栀
勦	剿
亯	享
睠	眷
頟	額
廁	厠
雞	鷄
廈	厦
錼	鎿
歎	嘆
槀	槁
鍊	煉 鏈 鍊
妳	你 奶
㚷	你 奶
霛	靈
衺	邪
輓	挽
舘	館
韤	襪
鎌	鐮
虖	呼
飈	飆
穅	糠
鍳	鑒
鬰	鬱
淒	凄
韝	鞲 韝
決	决
黃	黄
㪚	散
瑇	玳
惷	蠢
夘	卯
葯	藥
輭	軟
藂	叢
倃	咱
瓌	瑰
朶	朵
粵	粤
阯	址 阯
䛐	詞
鵉	鸞
庻	庶
坵	丘
槩	概
搯	掏
並	并
醃	腌
萲	萱
怱	匆
徧	遍
喆	哲 喆
揷	插
鳧	鳬
蹟	迹
併	并
𡡅	裊
偽	僞
牐	閘
讁	謫
戼	卯
瓈	璃
坿	附
毀	毁
堘	塍
蘂	蕊
凜	凛
匳	奩
媍	婦
踈	疏
藼	萱
薹	苔 薹
𤨏	瑣
霢	霡
帰	歸
塼	磚
嫺	嫻
疋	匹
豔	艷
鹻	碱
蠏	蟹
蒞	莅
娿	婀
叄	叁
饝	饃
扞	捍 扞
楥	楦
彷	彷 仿
寘	置
瑠	琉
蹻	蹺 屩 蹻
𥵃	盞
啗	啖
梲	棁
臕	膘
迯	逃
揜	掩
䶊	衄
俁	俣
麫	麵
剣	劍
満	滿
虯	虬
𩣏	桀
匟	炕
濶	闊
貓	猫
鬬	鬥
䘑	脉
聴	聽
雋	隽
蹧	糟
𣺌	渺
昇	升 昇
貍	狸
蘓	蘇
犂	犁
鷰	燕
俻	備
氷	冰
鵶	鴉
裡	裏
皜	皓
棲	栖
穪	稱
䬃	颯
颿	帆
媿	愧
鼴	鼹
巌	岩
竃	竈
欵	款
炤	照
恥	耻
閙	鬧
𨽻	隸
耑	專 耑
彞	彝
鬀	剃
祇	衹 祇
秖	衹
攷	考
樧	榝
寑	寢
顕	顯
墪	墩
涖	莅
弒	弑
斮	斫
靌	寶
兇	凶
柹	柿
雑	雜
疎	疏
鑚	鑽
儧	攢
搃	總
畮	畝
殼	殻
乹	乾
褵	縭
逥	迴
廹	迫
氊	氈
遡	溯
倐	倏
刼	劫
掙	挣
肎	肯
獃	呆
疿	痱
粃	秕
於	于 於
虛	虚
宮	宫
朢	望
冝	宜
濽	灒
祿	禄
彔	录
阨	厄
劒	劍
𥦗	窗
敍	叙
稺	稚
媼	媪
䋲	繩
況	况
悪	惡
蠔	蚝
癅	瘤
靱	韌
澣	浣
尒	爾
䊀	糊
𠪱	歷
彜	彝
閒	閑 間
鐫	鎸
讌	宴
羨	羡
銕	鐵
淨	净
肧	胚
恠	怪
醣	糖
𠻳	嗽
琱	雕
逈	迥
盋	鉢
羢	絨
曡	叠
碪	砧
瞖	翳
筍	笋
髴	佛
幇	幫
羣	群
琺	珐
欬	咳 欬
阬	坑
爼	俎
呌	叫
麞	獐
靭	韌
繡	綉
饟	餉
臥	卧
戱	戲
鎻	鎖
㫖	旨
幷	并
値	值
尙	尚
凂	浼
挿	插
瑉	珉
槪	概
揅	研
紏	糾
箚	札 劄
夑	燮
橣	檸
撃	擊
騌	鬃
鰌	鰍
筴	策 筴
傌	駡
鈆	鉛
煇	輝
頴	穎
駞	駝
糺	糾
紬	綢
鑑	鑒 鑑
厓	崖 睚 涯 厓
𧅰	護
髪	髮
鬂	鬢
籖	籤
髩	鬢
宼	寇
龝	秋
飡	餐
冦	寇
𪨷	岩
悮	誤
対	對
躱	躲
繋	繫
郰	鄹
湌	餐
郎	郎
豼	貔
敓	敚
偸	偷
楡	榆
婾	偷
喩	喻
兪	俞
飮	飲
逰	游
呑	吞
𠪾	歷
聨	聯
弾	彈
鼍	鼉
貟	員
夀	壽
屛	屏
淸	清
𣒣	芒
郞	郎
吿	告
緖	緒
㓕	滅
磗	磚
瑍	𤥺
顚	顛
倶	俱
厯	歷
涙	泪
髙	高
繈	襁
頺	頽
莭	節
髠	髡
鄕	鄉
塡	填
愼	慎
餋	養
靑	青
𦋀	罥
䒶	天
𠤷	匜
𥴦	篴
𠒋	凶
𦜕	跽
𠏉	幹
㵎	澗
𤍠	熱
菭	苔
嫓	媲
濳	潜
𤑔	爇
斾	旆
擥	攬
㮄	榜
糭	粽
鯰	鮎
彚	彙
濵	濱
𤮲	瓮
叅	參
劔	劍
踨	踪
鶑	鶯
浄	净
韀	韉
睂	眉
桞	柳
𰅫	𠥰
𩍴	𩎈
帲	帡
𧫮	𧩱
圎	圓
𦖯	䧦
𥅝	䀘
硏	研
𰧪	礸
𦸇	𦬸
騈	駢
𬵈	𩶾
𱄔	駰
𡙠	𡙛
𮂠	禶
姸	妍
𢩄	戽
𠸝	喋
𧯌	䜰
巓	巔
𧻞	趓
腁	胼
𥕦	磙
圗	圖
煕	熙
𩟪	饡
墍	塈
𤇆	烟
蔉	蓘
詽	訮
𪏡	斢
𢭇	摠
敻	夐
刴	剁
餠	餅
𬚹	𦚩
𦱍	菻
獔	獆
𰷻	𧽍
暭	暤
𧶀	𧶊
𥣪	穳
𢨾	戾
𰩇	窌
𥿰	𦀉
𦕻	聰
𥠺	蒀
𠌸	偋
𠛬	刑
𧪌	誱
𭥦	昴
𠰸	咽
𥁕	昷
𢷽	摡
翶	翱
𡠖	𡟷
𤀀	澚
漑	溉
𮒟	𧄽
𭟎	㦫
𦄲	縮
𡏲	塈
鷱	鷎
𡣶	㜺
𠆕	𢆣
噑	嗥
𢴀	摍
𧫲	諞
曁	暨
𦐧	羿
𭻐	𤱧
偼	倢
𧙊	裀
廽	迴
𨇃	躦
戸	户
𮝰	䡽
𪜭	個
豣	豜
𪡌	咨
郉	邢
𫩴	哚
𢊸	廪
𠅙	亮
𮃄	𥞛
𦨼	𦨳
𬹵	𪘉
𰙌	欭
𦲬	菻
𠋏	傊
𰱵	蓿
𮁳	𥙨
𥓁	硇
媫	婕
𡎖	塤
𥅳	䀘
痲	麻
𪬑	𫺬
𰹏	𨋖
𥧑	窴
輧	軿
𥔵	磁
倂	并
寏	𡨡
𬎨	𤬾
㛆	㛊
𦂟	繴
筓	笄
𨹃	𨹄
𮡯	鉚
𮦍	𩂞
𥄅	昈
𡂐	囋
廏	厩
皡	皞
逬	迸
𮍧	叟
𦢤	臢
𥬸	𥬲
𮀶	研
𢻻	啓
𥈤	睫
𫞟	爲
𨦃	䤪
𥳁	𥲤
𧧇	𧧨
𬆔	𣧷
挅	挆
槇	槙
𨝣	鄙
𣕹	𣓉
𧊱	𧊶
𭰊	洇
愌	𢚾
𨎊	𨍽
𪏖	䵎
𪇔	鷀
喞	唧
𦵉	萐
𥎞	䂎
𮆫	籫
𰡼	𤤸
甁	瓶
𣪩	殺
𬺠	龣
𡫞	逾
孶	孳
𫮰	墻
呉	吴
娯	娱
㯽	檳
𡣕	嬪
𢷤	擯
𣩵	殯
𥖶	𥖶
𦆯	繽
𦿜	薲
𧢘	䚔
𨮘	鑌
𨷚	𩰗
𩦿	驞
𩪯	髕
𩯭	鬢
𪇧	𪇕
𬛜	臏
𭀀	儐
𭿬	矉
𱁏	䨈
𱆉	𩰝
𱆡	𩴱
#注意	本行以下是为改进繁体文档混杂简体的状况而添加的转换，如您转换的是本身带有简体内容的文档，请删除以下内容
厂	廠
儿	兒
亏	虧
与	與
亿	億
个	個
广	廣
门	門
义	義
卫	衛
飞	飛
习	習
马	馬
乡	鄉
开	開
无	無
专	專
艺	藝
厅	廳
区	區
车	車
贝	貝
冈	岡
见	見
气	氣
长	長
币	幣
仅	僅
从	從
仑	侖
仓	倉
风	風
乌	烏
凤	鳳
为	爲
忆	憶
计	計
订	訂
认	認
讥	譏
队	隊
办	辦
邓	鄧
劝	勸
双	雙
书	書
击	擊
扑	撲
节	節
厉	厲
龙	龍
灭	滅
轧	軋
东	東
卢	盧
业	業
旧	舊
帅	帥
归	歸
电	電
号	號
叽	嘰
叹	嘆
们	們
仪	儀
丛	叢
尔	爾
乐	樂
处	處
鸟	鳥
务	務
冯	馮
闪	閃
兰	蘭
头	頭
汉	漢
宁	寧
讨	討
写	寫
让	讓
礼	禮
训	訓
议	議
讯	訊
记	記
辽	遼
边	邊
圣	聖
对	對
纠	糾
丝	絲
动	動
巩	鞏
执	執
扩	擴
扫	掃
场	場
扬	揚
亚	亞
机	機
权	權
过	過
协	協
压	壓
厌	厭
页	頁
夺	奪
达	達
夹	夾
轨	軌
尧	堯
迈	邁
毕	畢
贞	貞
师	師
尘	塵
吓	嚇
虫	蟲
吗	嗎
屿	嶼
岁	歲
岂	豈
则	則
刚	剛
网	網
迁	遷
乔	喬
伟	偉
传	傳
优	優
伤	傷
价	價
伦	倫
华	華
伪	僞
会	會
杀	殺
众	衆
爷	爺
伞	傘
创	創
杂	雜
负	負
壮	壯
妆	妝
庄	莊
庆	慶
刘	劉
齐	齊
产	産
闭	閉
问	問
闯	闖
关	關
灯	燈
汤	湯
兴	興
讲	講
讳	諱
军	軍
讶	訝
许	許
讹	訛
论	論
讼	訟
农	農
讽	諷
设	設
访	訪
诀	訣
寻	尋
导	導
孙	孫
阵	陣
阳	陽
阶	階
阴	陰
妇	婦
妈	媽
戏	戲
观	觀
欢	歡
买	買
红	紅
驮	馱
驯	馴
约	約
级	級
纪	紀
驰	馳
纫	紉
寿	壽
麦	麥
玛	瑪
进	進
远	遠
违	違
韧	韌
运	運
抚	撫
坏	壞
抠	摳
扰	擾
贡	貢
抡	掄
抢	搶
坟	墳
护	護
壳	殻
块	塊
声	聲
报	報
拟	擬
芜	蕪
苇	葦
苍	蒼
严	嚴
芦	蘆
劳	勞
极	極
杨	楊
两	兩
丽	麗
医	醫
励	勵
还	還
歼	殲
来	來
连	連
轩	軒
坚	堅
时	時
县	縣
呕	嘔
园	園
旷	曠
围	圍
吨	噸
邮	郵
员	員
听	聽
呛	嗆
呜	嗚
岖	嶇
岗	崗
帐	帳
财	財
针	針
钉	釘
乱	亂
体	體
佣	傭
彻	徹
邻	鄰
肠	腸
龟	龜
犹	猶
狈	狽
条	條
岛	島
饭	飯
饮	飲
冻	凍
状	狀
亩	畝
库	庫
疗	療
应	應
这	這
庐	廬
闰	閏
闲	閑
间	間
闷	悶
灶	竈
灿	燦
沥	瀝
沦	淪
沧	滄
沟	溝
沪	滬
怀	懷
忧	憂
穷	窮
证	證
启	啓
评	評
补	補
识	識
诈	詐
诉	訴
诊	診
词	詞
译	譯
灵	靈
层	層
迟	遲
张	張
际	際
陆	陸
陈	陳
坠	墜
劲	勁
鸡	鷄
纬	緯
驱	驅
纯	純
纱	紗
纲	綱
纳	納
驳	駁
纵	縱
纷	紛
纸	紙
纹	紋
纺	紡
驴	驢
纽	紐
环	環
责	責
现	現
规	規
拢	攏
拣	揀
担	擔
顶	頂
拥	擁
势	勢
拦	攔
拧	擰
拨	撥
择	擇
茎	莖
枢	樞
柜	櫃
枪	槍
枫	楓
构	構
丧	喪
画	畫
枣	棗
卖	賣
矾	礬
矿	礦
码	碼
厕	厠
奋	奮
态	態
欧	歐
殴	毆
垄	壟
轰	轟
顷	頃
转	轉
斩	斬
轮	輪
软	軟
齿	齒
虏	虜
肾	腎
贤	賢
国	國
畅	暢
咙	嚨
鸣	鳴
罗	羅
帜	幟
岭	嶺
凯	凱
败	敗
账	賬
贩	販
贬	貶
购	購
贮	貯
图	圖
钓	釣
侠	俠
侥	僥
侦	偵
侧	側
凭	憑
侨	僑
货	貨
质	質
径	徑
觅	覓
贪	貪
贫	貧
肤	膚
肿	腫
胀	脹
肮	骯
胁	脅
鱼	魚
狞	獰
备	備
饰	飾
饱	飽
饲	飼
变	變
庞	龐
庙	廟
疟	瘧
剂	劑
废	廢
闸	閘
闹	鬧
郑	鄭
单	單
炉	爐
浅	淺
泞	濘
泻	瀉
泼	潑
泽	澤
怜	憐
学	學
宝	寶
宠	寵
审	審
实	實
试	試
诗	詩
诚	誠
衬	襯
视	視
话	話
诞	誕
诡	詭
询	詢
该	該
详	詳
肃	肅
隶	隸
陕	陝
驾	駕
参	參
艰	艱
线	綫
练	練
组	組
绅	紳
细	細
驶	駛
织	織
驹	駒
终	終
驻	駐
绊	絆
驼	駝
绍	紹
绎	繹
经	經
贯	貫
贰	貳
帮	幫
项	項
挟	挾
挠	撓
赵	趙
挡	擋
垫	墊
挤	擠
挥	揮
荐	薦
带	帶
茧	繭
荡	蕩
荣	榮
荤	葷
荧	熒
荫	蔭
药	藥
标	標
栈	棧
栋	棟
栏	欄
柠	檸
树	樹
砖	磚
砚	硯
牵	牽
鸥	鷗
残	殘
轴	軸
轻	輕
鸦	鴉
战	戰
点	點
临	臨
览	覽
竖	竪
尝	嘗
哑	啞
显	顯
贵	貴
虾	蝦
蚁	蟻
蚂	螞
虽	雖
骂	駡
勋	勛
哗	嘩
响	響
哟	喲
峡	峽
罚	罰
贱	賤
贴	貼
贻	貽
钙	鈣
钝	鈍
钞	鈔
钢	鋼
钠	鈉
钥	鑰
钦	欽
钧	鈞
钩	鈎
钮	鈕
毡	氈
氢	氫
选	選
适	適
俩	倆
贷	貸
顺	順
俭	儉
剑	劍
胧	朧
胆	膽
胜	勝
狭	狹
狮	獅
独	獨
狱	獄
贸	貿
饵	餌
饶	饒
蚀	蝕
饺	餃
饼	餅
峦	巒
弯	彎
将	將
奖	奬
疮	瘡
疯	瘋
亲	親
闺	閨
闻	聞
闽	閩
阀	閥
阁	閣
养	養
类	類
娄	婁
总	總
炼	煉
烁	爍
烂	爛
洼	窪
洁	潔
洒	灑
浇	澆
浊	濁
测	測
浏	瀏
济	濟
浑	渾
浓	濃
恼	惱
举	舉
觉	覺
宪	憲
窃	竊
诫	誡
诬	誣
语	語
袄	襖
误	誤
诱	誘
诲	誨
说	説
诵	誦
垦	墾
昼	晝
费	費
逊	遜
陨	隕
险	險
娇	嬌
贺	賀
垒	壘
绑	綁
绒	絨
结	結
绕	繞
骄	驕
绘	繪
给	給
绚	絢
骆	駱
络	絡
绝	絶
绞	絞
骇	駭
统	統
艳	艷
蚕	蠶
顽	頑
盏	盞
捞	撈
载	載
赶	趕
盐	鹽
损	損
捡	撿
挚	摯
热	熱
捣	搗
壶	壺
聂	聶
莱	萊
莲	蓮
莹	瑩
莺	鶯
档	檔
桥	橋
桦	樺
桩	樁
样	樣
贾	賈
砾	礫
础	礎
顾	顧
轿	轎
较	較
顿	頓
毙	斃
虑	慮
监	監
紧	緊
晒	曬
晓	曉
唠	嘮
鸭	鴨
晕	暈
鸯	鴦
罢	罷
圆	圓
贼	賊
贿	賄
赂	賂
赃	贜
钱	錢
钳	鉗
钻	鑽
钾	鉀
铁	鐵
铃	鈴
铅	鉛
牺	犧
敌	敵
积	積
称	稱
笔	筆
债	債
倾	傾
赁	賃
舰	艦
舱	艙
耸	聳
爱	愛
颁	頒
颂	頌
脐	臍
胶	膠
脑	腦
脓	膿
鸵	鴕
鸳	鴛
皱	皺
饿	餓
馁	餒
恋	戀
桨	槳
浆	漿
斋	齋
离	離
资	資
竞	競
阅	閲
烦	煩
烧	燒
烛	燭
递	遞
涛	濤
涝	澇
涡	渦
涤	滌
润	潤
涧	澗
涨	漲
烫	燙
涩	澀
悯	憫
宽	寬
宾	賓
窍	竅
请	請
诸	諸
诺	諾
读	讀
诽	誹
袜	襪
课	課
谁	誰
调	調
谅	諒
谆	諄
谈	談
谊	誼
恳	懇
剧	劇
难	難
预	預
绢	絹
绣	綉
验	驗
继	繼
骏	駿
琐	瑣
掷	擲
掺	摻
职	職
萝	蘿
萤	螢
营	營
萧	蕭
萨	薩
梦	夢
检	檢
酝	醖
硕	碩
聋	聾
袭	襲
辅	輔
辆	輛
颅	顱
悬	懸
跃	躍
啰	囉
啸	嘯
崭	嶄
逻	邏
婴	嬰
铐	銬
铛	鐺
铝	鋁
铜	銅
铭	銘
铲	鏟
银	銀
矫	矯
秽	穢
笼	籠
偿	償
躯	軀
衅	釁
衔	銜
盘	盤
鸽	鴿
敛	斂
领	領
脸	臉
猎	獵
馅	餡
馆	館
痒	癢
阎	閻
阐	闡
盖	蓋
断	斷
兽	獸
鸿	鴻
渐	漸
渊	淵
渔	漁
渗	滲
惭	慚
惧	懼
惊	驚
惨	慘
惯	慣
谋	謀
谍	諜
谎	謊
谐	諧
祷	禱
祸	禍
谓	謂
谚	諺
谜	謎
弹	彈
堕	墮
随	隨
隐	隱
婶	嬸
颇	頗
颈	頸
绩	績
绪	緒
续	續
骑	騎
绰	綽
绳	繩
维	維
绵	綿
绷	綳
绸	綢
综	綜
绽	綻
绿	緑
缀	綴
琼	瓊
趋	趨
揽	攬
搀	攙
搁	擱
搂	摟
搅	攪
联	聯
蒋	蔣
韩	韓
椭	橢
确	確
颊	頰
雳	靂
暂	暫
翘	翹
辈	輩
凿	鑿
辉	輝
赏	賞
睐	睞
喷	噴
畴	疇
践	踐
遗	遺
鹃	鵑
赋	賦
赌	賭
赎	贖
赐	賜
赔	賠
铸	鑄
铺	鋪
链	鏈
销	銷
锁	鎖
锄	鋤
锅	鍋
锈	銹
锋	鋒
锌	鋅
锐	鋭
鹅	鵝
筛	篩
储	儲
惩	懲
释	釋
腊	臘
鲁	魯
惫	憊
馈	饋
馋	饞
装	裝
蛮	蠻
阔	闊
粪	糞
滞	滯
湿	濕
溃	潰
溅	濺
湾	灣
愤	憤
窜	竄
窝	窩
裤	褲
禅	禪
谢	謝
谣	謡
谤	謗
谦	謙
属	屬
屡	屢
缅	緬
缆	纜
缉	緝
缎	緞
缓	緩
缔	締
缕	縷
骗	騙
编	編
骚	騷
缘	緣
鹉	鵡
摄	攝
摊	攤
鹊	鵲
蓝	藍
献	獻
榄	欖
楼	樓
赖	賴
碍	礙
尴	尷
雾	霧
辐	輻
辑	輯
输	輸
频	頻
龄	齡
鉴	鑒
跷	蹺
蜗	蝸
错	錯
锚	錨
锡	錫
锣	鑼
锤	錘
锥	錐
锦	錦
键	鍵
锯	鋸
锰	錳
辞	辭
颓	頽
筹	籌
简	簡
腻	膩
鹏	鵬
腾	騰
鲍	鮑
颖	穎
触	觸
雏	雛
馍	饃
馏	餾
酱	醬
誊	謄
粮	糧
数	數
满	滿
滤	濾
滥	濫
滨	濱
滩	灘
誉	譽
窥	窺
寝	寢
谨	謹
谬	謬
缚	縛
缝	縫
缠	纏
缤	繽
赘	贅
墙	墻
蔼	藹
槛	檻
酿	釀
愿	願 愿
辖	轄
辗	輾
颗	顆
踊	踴
蜡	蠟
蝇	蠅
蝉	蟬
赚	賺
锹	鍬
锻	鍛
镀	鍍
稳	穩
箩	籮
箫	簫
舆	輿
鲜	鮮
馒	饅
潇	瀟
赛	賽
谭	譚
谱	譜
骡	騾
缩	縮
撵	攆
聪	聰
蕴	藴
樱	櫻
飘	飄
霉	黴
瞒	瞞
题	題
嘱	囑
镇	鎮
镐	鎬
镑	鎊
篓	簍
鲤	鯉
鲫	鯽
瘪	癟
瘫	癱
颜	顔
鲨	鯊
澜	瀾
额	額
谴	譴
鹤	鶴
缭	繚
颠	顛
辙	轍
鹦	鸚
赠	贈
镜	鏡
赞	贊
篮	籃
鲸	鯨
瘾	癮
辩	辯
濒	瀕
懒	懶
缰	繮
缴	繳
瞩	矚
赡	贍
鳄	鰐
辫	辮
赢	贏
骤	驟
嚣	囂
镰	鐮
鳍	鰭
鹰	鷹
巅	巔
颤	顫
癣	癬
鳖	鱉
鬓	鬢
鳞	鱗
躏	躪
赣	贛
镶	鑲
韦	韋
闩	閂
讣	訃
劢	勱
刍	芻
邝	鄺
讦	訐
讧	訌
讪	訕
讫	訖
驭	馭
玑	璣
圹	壙
扪	捫
芗	薌
厍	厙
钇	釔
伛	傴
伥	倀
伧	傖
犷	獷
犸	獁
凫	鳬
邬	鄔
饧	餳
忏	懺
讴	謳
讵	詎
讷	訥
纡	紆
纣	紂
纥	紇
纨	紈
玙	璵
抟	摶
坞	塢
㧐	㩳
苈	藶
苋	莧
苌	萇
苁	蓯
矶	磯
奁	奩
欤	歟
轫	軔
邺	鄴
呒	嘸
呓	囈
呖	嚦
旸	暘
呗	唄
帏	幃
岘	峴
岚	嵐
囵	圇
钊	釗
钋	釙
钌	釕
佥	僉
鸠	鳩
邹	鄒
饨	飩
饩	餼
饪	飪
饫	飫
饬	飭
庑	廡
疖	癤
闱	闈
闳	閎
闵	閔
炀	煬
沣	灃
沤	漚
沨	渢
沩	潙
怃	憮
怄	慪
忾	愾
怅	悵
怆	愴
诂	詁
诃	訶
诅	詛
诋	詆
诌	謅
诏	詔
诒	詒
陇	隴
陉	陘
妩	嫵
妪	嫗
妫	嬀
刭	剄
纭	紜
纰	紕
纴	紝
纶	綸
纾	紓
玮	瑋
匦	匭
垆	壚
㧟	擓
茏	蘢
茑	蔦
茔	塋
茕	煢
枥	櫪
枧	梘
枨	棖
枞	樅
砀	碭
瓯	甌
郏	郟
轭	軛
鸢	鳶
昙	曇
虮	蟣
黾	黽
咛	嚀
咝	噝
岿	巋
刿	劌
剀	剴
峄	嶧
钍	釷
钎	釺
钏	釧
钒	釩
钕	釹
钗	釵
侩	儈
侪	儕
侬	儂
刽	劊
怂	慫
籴	糴
戗	戧
䏝	膞
迩	邇
枭	梟
饯	餞
饴	飴
疠	癘
疡	瘍
炜	煒
𬉼	熰
炝	熗
泷	瀧
泸	瀘
泺	濼
泾	涇
㤘	㥮
怿	懌
诓	誆
诔	誄
诖	詿
诘	詰
诙	詼
郓	鄆
祎	禕
诛	誅
诜	詵
诟	詬
诠	詮
诣	詣
诤	諍
诧	詫
诨	諢
诩	詡
驽	駑
绀	紺
绁	紲
绂	紱
驷	駟
驸	駙
绉	縐
绌	絀
驿	驛
骀	駘
珑	瓏
顸	頇
垭	埡
挝	撾
挞	撻
贲	賁
垱	壋
挦	撏
荚	莢
贳	貰
荜	蓽
荞	蕎
荟	薈
荠	薺
垩	堊
荥	滎
荦	犖
荨	蕁
荩	藎
荪	蓀
荬	蕒
荮	葤
栉	櫛
栊	櫳
栌	櫨
栎	櫟
柽	檉
郦	酈
砗	硨
砜	碸
殇	殤
轱	軲
轲	軻
轳	轤
轶	軼
轸	軫
虿	蠆
觇	覘
眍	瞘
哓	嘵
哔	嗶
哕	噦
剐	剮
郧	鄖
哙	噲
哝	噥
峣	嶢
帧	幀
峤	嶠
贶	貺
钚	鈈
钛	鈦
钡	鋇
钣	鈑
钤	鈐
钨	鎢
钫	鈁
钯	鈀
笃	篤
俦	儔
俨	儼
俪	儷
胨	腖
胪	臚
胫	脛
鸨	鴇
狯	獪
飑	颮
狲	猻
饷	餉
饸	餄
饹	餎
孪	孿
娈	孌
疬	癧
疭	瘲
飒	颯
闼	闥
闾	閭
闿	闓
阂	閡
炽	熾
烃	烴
浃	浹
浍	澮
浒	滸
浔	潯
浕	濜
恸	慟
恹	懨
恺	愷
恻	惻
恽	惲
诮	誚
祢	禰
诰	誥
诳	誑
鸩	鴆
娅	婭
娆	嬈
怼	懟
绔	絝
骁	驍
骅	驊
绗	絎
绛	絳
骈	駢
顼	頊
珰	璫
珲	琿
埘	塒
埙	塤
埚	堝
贽	贄
莳	蒔
莴	萵
莸	蕕
鸪	鴣
莼	蒓
桡	橈
桢	楨
桤	榿
桧	檜
逦	邐
砺	礪
砻	礱
轼	軾
轾	輊
辂	輅
鸫	鶇
趸	躉
龀	齔
鸬	鸕
眬	矓
唛	嘜
鸮	鴞
蚬	蜆
唢	嗩
崂	嶗
崃	崍
觊	覬
赅	賅
钰	鈺
钲	鉦
钴	鈷
钵	鉢
钹	鈸
钺	鉞
钽	鉭
钼	鉬
钿	鈿
铀	鈾
铂	鉑
铄	鑠
铆	鉚
铈	鈰
铉	鉉
铊	鉈
铋	鉍
铌	鈮
铍	鈹
䥽	鏺
铎	鐸
氩	氬
笕	筧
颀	頎
徕	徠
脍	膾
鸱	鴟
玺	璽
鸲	鴝
猃	獫
袅	裊
饽	餑
栾	欒
挛	攣
痈	癰
痉	痙
颃	頏
阃	閫
阄	鬮
訚	誾
阆	閬
郸	鄲
烨	燁
烩	燴
烬	燼
涞	淶
涟	漣
涠	潿
悭	慳
诹	諏
诼	諑
祯	禎
诿	諉
谀	諛
谂	諗
谄	諂
谇	誶
娲	媧
娴	嫻
绠	綆
骊	驪
绡	綃
骋	騁
绥	綏
绦	縧
绨	綈
骎	駸
鸶	鷥
焘	燾
琏	璉
麸	麩
掳	擄
掴	摑
鸷	鷙
掸	撣
悫	慤
掼	摜
萦	縈
梿	槤
觋	覡
棂	欞
啬	嗇
匮	匱
硖	硤
硗	磽
鸸	鴯
龚	龔
殒	殞
殓	殮
赉	賚
辄	輒
堑	塹
啧	嘖
啭	囀
啮	嚙
跄	蹌
蛎	蠣
蛊	蠱
蛏	蟶
帻	幘
帼	幗
赇	賕
赈	賑
赊	賒
铑	銠
铒	鉺
铗	鋏
铙	鐃
铟	銦
铠	鎧
铡	鍘
铢	銖
铣	銑
铤	鋌
铧	鏵
铨	銓
铩	鎩
铪	鉿
铫	銚
铬	鉻
铮	錚
铯	銫
铰	鉸
铱	銥
铳	銃
铵	銨
铷	銣
鸹	鴰
秾	穠
笺	箋
笾	籩
偾	僨
偻	僂
皑	皚
鸻	鴴
舻	艫
龛	龕
猡	玀
猕	獼
馃	餜
馄	餛
鸾	鸞
阇	闍
阈	閾
阉	閹
阊	閶
阋	鬩
阍	閽
阏	閼
羟	羥
粝	糲
焖	燜
渍	漬
渎	瀆
渑	澠
惬	愜
惮	憚
谌	諶
谏	諫
皲	皸
谑	謔
裆	襠
谒	謁
谔	諤
谕	諭
谖	諼
谗	讒
谙	諳
谛	諦
谝	諞
粜	糶
婵	嬋
绫	綾
骐	騏
绮	綺
绯	緋
绱	緔
骒	騍
绲	緄
骓	騅
绶	綬
绺	綹
绻	綣
绾	綰
骖	驂
缁	緇
靓	靚
辇	輦
鼋	黿
颉	頡
揿	撳
蛰	蟄
塆	壪
蒌	蔞
椟	櫝
椤	欏
赍	賫
鹁	鵓
鹂	鸝
殚	殫
辊	輥
辋	輞
椠	槧
辍	輟
辎	輜
睑	瞼
跞	躒
蛱	蛺
蛲	蟯
蛳	螄
蛴	蠐
喽	嘍
嵘	嶸
嵝	嶁
赕	賧
铻	鋙
铼	錸
铿	鏗
锃	鋥
锂	鋰
锆	鋯
锇	鋨
锉	銼
锏	鐧
锑	銻
锒	鋃
锔	鋦
锕	錒
犊	犢
鹄	鵠
筚	篳
牍	牘
傥	儻
傧	儐
傩	儺
媭	嬃
颌	頜
鹆	鵒
鱿	魷
鲀	魨
鲂	魴
颍	潁
飓	颶
觞	觴
颎	熲
馇	餷
馊	餿
亵	褻
脔	臠
痨	癆
痫	癇
赓	賡
颏	頦
鹇	鷳
阑	闌
阒	闃
阕	闋
鹈	鵜
愦	憒
喾	嚳
谟	謨
裢	褳
裥	襇
谠	讜
谡	謖
谥	謚
谧	謐
骘	騭
巯	巰
翚	翬
骛	騖
缂	緙
缃	緗
缄	緘
缇	緹
缈	緲
缌	緦
缑	緱
缒	縋
缗	緡
飨	饗
耢	耮
骜	驁
韫	韞
摅	攄
摈	擯
毂	轂
蓦	驀
鹋	鶓
蓟	薊
蓠	蘺
蓥	鎣
颐	頤
榈	櫚
榉	櫸
碛	磧
碜	磣
鹌	鵪
辏	輳
龃	齟
龅	齙
韪	韙
嗫	囁
跶	躂
跸	蹕
跹	躚
跻	躋
嗳	噯
锗	鍺
锛	錛
锜	錡
锝	鍀
锞	錁
锟	錕
锢	錮
锨	鍁
锩	錈
锭	錠
锱	錙
觎	覦
颔	頷
鲅	鮁
鲆	鮃
鲇	鮎
鲈	鱸
稣	穌
鲋	鮒
鲐	鮐
鹐	鵮
飕	颼
馐	饈
鹑	鶉
瘆	瘮
阖	闔
阗	闐
阙	闕
滟	灧
滢	瀅
滗	潷
滦	灤
滪	澦
慑	懾
鲎	鱟
骞	騫
窦	竇
谩	謾
谪	謫
嫒	嬡
嫔	嬪
缙	縉
缜	縝
缛	縟
辔	轡
骝	騮
缟	縞
缡	縭
缢	縊
缣	縑
骟	騸
觏	覯
韬	韜
叆	靉
撄	攖
蔷	薔
蔺	藺
鹕	鶘
槟	檳
槠	櫧
酽	釅
殡	殯
霁	霽
辕	轅
龇	齜
龈	齦
䁖	瞜
暧	曖
踌	躊
蝈	蟈
鹗	鶚
嘤	嚶
罴	羆
赙	賻
罂	罌
鹘	鶻
锲	鍥
锴	鍇
锶	鍶
锷	鍔
锸	鍤
锵	鏘
镁	鎂
镂	鏤
箦	簀
箧	篋
箪	簞
箓	籙
膑	臏
鲑	鮭
鲔	鮪
鲚	鱭
鲛	鮫
鲟	鱘
馑	饉
銮	鑾
瘘	瘻
阚	闞
鲞	鮝
糁	糝
鹚	鷀
潋	瀲
潍	濰
谮	譖
褛	褸
谯	譙
谰	讕
谲	譎
鹛	鶥
嫱	嬙
鹜	鶩
骠	驃
缥	縹
缦	縵
缧	縲
缨	纓
骢	驄
缪	繆
缫	繅
耧	耬
璎	瓔
撷	擷
撸	擼
撺	攛
聩	聵
觐	覲
鞑	韃
鞒	鞽
蕲	蘄
赜	賾
樯	檣
靥	靨
魇	魘
餍	饜
辘	轆
龉	齬
龊	齪
觑	覷
颙	顒
踬	躓
踯	躑
蝾	蠑
蝼	螻
颚	顎
噜	嚕
颛	顓
镊	鑷
镉	鎘
镌	鎸
镍	鎳
镏	鎦
镒	鎰
镓	鎵
镔	鑌
篑	簣
鹞	鷂
鲠	鯁
鲡	鱺
鲢	鰱
鲣	鰹
鲥	鰣
鲧	鯀
鲩	鯇
觯	觶
馓	饊
馔	饌
齑	齏
谳	讞
褴	襤
谵	譫
屦	屨
缬	纈
缮	繕
缯	繒
骣	驏
擞	擻
颞	顳
颟	顢
薮	藪
橹	櫓
橼	櫞
赝	贋
飙	飆
錾	鏨
辚	轔
螨	蟎
䦃	鐯
镖	鏢
镗	鏜
镘	鏝
镚	鏰
镛	鏞
镝	鏑
镞	鏃
镠	鏐
氇	氌
穑	穡
魉	魎
鲮	鯪
鲱	鯡
鲲	鯤
鲳	鯧
鲴	鯝
鲵	鯢
鲷	鯛
鲻	鯔
獭	獺
鹧	鷓
赟	贇
瘿	癭
斓	斕
濑	瀨
颡	顙
缱	繾
缲	繰
缳	繯
藓	蘚
鹩	鷯
龋	齲
龌	齷
蹑	躡
蹒	蹣
羁	羈
镡	鐔
镢	鐝
镣	鐐
镦	鐓
镧	鑭
镩	鑹
镪	鏹
镫	鐙
簖	籪
鹪	鷦
鲼	鱝
鲽	鰈
鳀	鯷
鳃	鰓
鳅	鰍
鳇	鰉
鳊	鯿
鹫	鷲
懑	懣
鹬	鷸
鳌	鰲
鞯	韉
颢	顥
鹭	鷺
鹮	䴉
髅	髏
镬	鑊
镭	鐳
镯	鐲
雠	讎
鳎	鰨
鳏	鰥
鳐	鰩
癞	癩
攒	攢
霭	靄
蹿	躥
髋	髖
髌	髕
镲	鑔
籁	籟
鳓	鰳
鳔	鰾
鳕	鱈
鳗	鰻
鳙	鱅
谶	讖
骥	驥
缵	纘
瓒	瓚
黩	黷
黪	黲
镳	鑣
镴	鑞
臜	臢
鳜	鱖
鳝	鱔
鳟	鱒
骧	驤
颦	顰
鳢	鱧
癫	癲
灏	灝
鹳	鸛
镵	鑱
趱	趲
颧	顴
躜	躦
馕	饢
戆	戇
戋	戔
𬣙	訏
讱	訒
钆	釓
伣	俔
闫	閆
𬇕	澫
䜣	訢
讻	訩
𬣞	詝
𬘓	紃
纩	纊
玚	瑒
刬	剗
𫭟	塸
坜	壢
𫭢	埨
㧑	撝
𫇭	蔿
杩	榪
轪	軑
𫐄	軏
呙	咼
𫵷	㠣
觃	覎
㑇	㑳
飏	颺
闶	閌
𣲘	潕
𣲗	湋
沄	澐
𬇙	浿
𬣡	諓
祃	禡
诇	詗
诎	詘
诐	詖
屃	屓
𫸩	彄
纮	紘
驲	馹
𫘜	馼
纻	紵
𬘘	紞
𫘝	駃
纼	紖
玱	瑲
㭎	棡
𬨂	軝
𬀩	暐
𬀪	晛
岽	崬
𬬩	釴
钐	釤
钔	鍆
钖	鍚
郐	鄶
狝	獮
饳	飿
峃	嶨
𫍣	詷
𬣳	詪
𬩽	鄩
鸤	鳲
𬮿	隑
𬯀	隮
𫰛	娙
迳	逕
𬳵	駓
驵	駔
𬳶	駉
䌹	絅
驺	騶
𫠊	䮄
绋	紼
绐	紿
𬍛	瓅
韨	韍
垯	墶
垲	塏
荙	薘
荛	蕘
𬜬	蔄
荭	葒
䴓	鳾
䶮	龑
轵	軹
轷	軤
轹	轢
轺	軺
𪾢	睍
昽	曨
哒	噠
钘	鈃
𫓧	鈇
钜	鉅
𬬮	鋹
𬬱	釿
𬬭	錀
钪	鈧
钬	鈥
钭	鈄
俫	倈
舣	艤
鸧	鶬
飐	颭
饻	餏
浈	湞
浉	溮
浐	滻
袆	褘
绖	絰
骃	駰
𬘡	絪
𬳽	駪
𬘩	綎
𫄧	綖
骉	驫
𪟝	勣
𬍤	璕
𫭼	𡑍
𬜯	䓣
莶	薟
䓖	藭
桠	椏
𬂩	梜
𫠆	頍
硁	硜
𨐈	輄
辀	輈
辁	輇
赀	貲
唝	嗊
晔	曄
晖	暉
𫑡	鄳
帱	幬
𪨶	輋
崄	嶮
赆	贐
𬬸	鉥
钷	鉕
𬬻	鑪
𬬹	鉮
𬬿	鉊
𬭁	鉧
𫢸	僤
鸰	鴒
鱽	魛
𫗧	餗
𬊈	燖
涢	溳
𬒈	礐
窎	窵
袯	襏
𬳿	駼
𫄨	絺
绤	綌
骍	騂
𬘫	綄
琎	璡
𫮃	墠
壸	壼
聍	聹
萚	蘀
勚	勩
䓨	罃
梼	檮
梾	棶
厣	厴
鿎	䃮
硙	磑
硚	礄
䴕	鴷
龁	齕
𬱖	頔
𬟽	蝀
啴	嘽
铏	鉶
𫓯	銈
𫟹	鉷
铕	銪
𫟼	鐽
铖	鋮
铘	鋣
铚	銍
铞	銱
铥	銩
铴	鐋
鸺	鵂
鸼	鵃
䝙	貙
脶	腡
鱾	魢
庼	廎
䴔	鵁
阌	閿
𬇹	漍
𬍡	璗
𬤇	諲
𫍯	諴
裈	褌
𬤊	諟
𫍲	謏
谞	諝
𬯎	隤
婳	嫿
𬘬	綪
𬘭	綝
𬴂	騑
𫘦	騊
绹	綯
𫟅	綡
𬘯	綧
骕	驌
𫘧	騄
絷	縶
𪣻	塿
蒇	蕆
蒉	蕢
𬃊	櫍
鹀	鵐
𬷕	鵏
酦	醱
觌	覿
詟	讋
𫐐	輗
辌	輬
龂	齗
𬹼	齘
𫶇	嵽
嵚	嶔
翙	翽
𫖮	顗
赑	贔
赒	賙
鿏	䥑
铹	鐒
𬭊	𨧀
铽	鋱
𨱇	銶
𫓶	鋗
锊	鋝
锍	鋶
锎	鐦
𬭎	鋐
锓	鋟
颋	頲
筜	簹
𫖯	頫
腘	膕
𬱟	頠
鲃	䰾
𫛭	鵟
馉	餶
𫷷	廞
𬮱	闉
𬊤	燀
𣸣	濆
溁	濚
溇	漊
敩	斆
裣	襝
毵	毿
𬴃	騞
𫘨	騠
缊	緼
缐	線
骙	騤
䴖	鶄
赪	赬
蓣	蕷
榇	櫬
𬪩	醲
䃅	磾
辒	輼
𬨎	輶
𫐓	輮
龆	齠
鹍	鵾
赗	賵
锖	錆
𫓹	錤
锘	鍩
锳	鍈
锧	鑕
锪	鍃
𬭚	錞
锫	錇
锬	錟
𬭛	𨨏
䅟	穇
𬕂	篢
筼	篔
鹎	鵯
鲉	鮋
鲊	鮓
鲌	鮊
䲟	鮣
𬶋	鮈
𬶍	鮀
鲏	鮍
飔	颸
𦝼	膢
馌	饁
瘅	癉
鹒	鶊
阘	闒
𫔶	闑
滠	灄
𫌀	襀
谫	謭
鹔	鷫
𫖳	頵
𫘪	騵
𫘬	騱
缞	縗
𫞩	璊
瑷	璦
蔹	蘞
槚	檟
𣗋	欓
𬸘	鶠
酾	釃
𬒗	𥗽
𫚖	鮆
䴗	鶪
鹖	鶡
𨱏	鎝
锼	鎪
锽	鍠
𬭤	鍭
锾	鍰
锿	鎄
镃	鎡
镄	鐨
镅	鎇
鹙	鶖
箨	籜
鲒	鮚
鲕	鮞
𫚕	鰤
鲖	鮦
鲗	鰂
鲘	鮜
鲙	鱠
𬶐	鮡
𬶏	鮠
𩽾	鮟
飗	飀
𬸚	鸑
瘗	瘞
鲝	鮺
潆	瀠
窭	窶
𬤝	譓
𬙂	縯
麹	麴
叇	靆
鹝	鷊
慭	憖
䗖	螮
镆	鏌
镈	鎛
镋	钂
镎	鎿
𬭩	鎓
镕	鎔
䴘	鷉
鹟	鶲
𩾃	鮸
鲦	鰷
鲪	鮶
鲬	鯒
鹠	鶹
鹡	鶺
鹢	鷁
鹣	鶼
澛	瀂
𬸣	鶱
𫍽	譞
𬴊	驎
豮	豶
𫟦	䡵
𬺈	齮
𫠜	齯
鹾	鹺
𪩘	巘
𬭬	鏏
𨱑	鐄
𬭯	䥕
篯	籛
鲭	鯖
鲯	鯕
鲰	鯫
鲺	鯴
鲹	鰺
𫗴	饘
亸	嚲
𬸦	鷟
黉	黌
鹨	鷚
𫄷	繶
𤩽	瓛
蟏	蠨
㘎	㘚
𬭳	𨭎
镤	鏷
𬭶	𨭆
𫔍	鐇
镥	鑥
镨	鐠
𬭸	鏻
𨱔	鐏
𬭼	鐩
𫔎	鐍
𬸪	鷭
䲠	鰆
𬶟	鯻
鲾	鰏
𬶠	鰊
鲿	鱨
鳁	鰛
鳂	鰃
鳈	鰁
鳉	鱂
襕	襴
𬶨	鱀
𦈡	繻
𫄸	纁
鬶	鬹
𬟁	虉
鹲	鸏
黡	黶
镮	鐶
镱	鐿
酂	酇
䲢	鰧
鳑	鰟
鳒	鰜
鹱	鸌
鹯	鸇
冁	囅
䴙	鸊
𬙊	纆
鳘	鰵
𬶭	鰶
𩾌	鱇
鳚	䲁
鳛	鰼
彟	彠
颥	顬
𬶮	鱚
骦	驦
𬙋	纕
𬺓	齼
鳠	鱯
鳡	鱤
鳣	鱣
鹴	鸘
鳤	䲘
𫚭	鱲